data_somministrazione,area,totale,sesso_maschile,sesso_femminile,categoria_operatori_sanitari_sociosanitari,categoria_personale_non_sanitario,categoria_altro,categoria_ospiti_rsa,categoria_over80,categoria_forze_armate,categoria_personale_scolastico,prima_dose,seconda_dose,codice_NUTS1,codice_NUTS2,codice_regione_ISTAT,nome_area
2021-02-01,PIE,8642,3053,5589,6170,1325,79,1068,0,0,0,578,8064,ITC,ITC1,1,Piemonte
2021-02-01,UMB,1260,333,927,875,33,0,352,0,0,0,47,1213,ITI,ITI2,10,Umbria
2021-03-21,MOL,1246,542,704,14,1,141,0,1090,0,0,479,767,ITF,ITF2,14,Molise
2021-03-21,PUG,2673,1220,1453,462,15,104,13,1779,15,285,570,2103,ITF,ITF4,16,Puglia
2021-01-04,PAB,508,201,307,420,49,35,4,0,0,0,508,0,ITH,ITH1,4,Provincia Autonoma Bolzano / Bozen
2021-02-28,LOM,7884,3255,4629,1106,694,1587,76,4308,82,31,7668,216,ITC,ITC4,3,Lombardia
2021-01-30,CAL,2173,1147,1026,1974,0,199,0,0,0,0,358,1815,ITF,ITF6,18,Calabria
2021-02-19,PIE,5529,2171,3358,1989,788,977,666,31,0,1078,5027,502,ITC,ITC1,1,Piemonte
2021-01-04,TOS,5065,1894,3171,4100,29,3,933,0,0,0,5065,0,ITI,ITI1,9,Toscana
2021-03-19,LOM,32326,12873,19453,2730,1717,896,1411,22413,150,3009,19163,13163,ITC,ITC4,3,Lombardia
2021-01-17,EMR,2890,887,2003,1914,278,147,547,0,0,4,2644,246,ITH,ITH5,8,Emilia-Romagna
2021-03-07,MOL,1131,501,630,2,16,0,0,1113,0,0,1129,2,ITF,ITF2,14,Molise
2021-04-13,LAZ,24852,11537,13315,2349,106,14768,289,7271,15,54,17256,7596,ITI,ITI4,12,Lazio
2021-02-15,LOM,8912,3119,5793,6033,1613,151,1071,4,31,9,8491,421,ITC,ITC4,3,Lombardia
2021-02-17,SIC,5434,3294,2140,1531,118,1009,880,8,1886,2,4760,674,ITG,ITG1,19,Sicilia
2021-01-07,LIG,3230,1095,2135,2340,144,275,466,0,1,4,3230,0,ITC,ITC3,7,Liguria
2020-12-31,EMR,2205,777,1428,1676,30,171,328,0,0,0,2205,0,ITH,ITH5,8,Emilia-Romagna
2021-03-11,TOS,15454,5980,9474,2440,907,1374,270,10244,207,12,12136,3318,ITI,ITI1,9,Toscana
2021-01-12,CAL,2058,1017,1041,1706,0,323,29,0,0,0,2058,0,ITF,ITF6,18,Calabria
2021-01-17,ABR,187,59,128,136,13,38,0,0,0,0,180,7,ITF,ITF1,13,Abruzzo
2021-01-24,FVG,305,119,186,277,0,27,1,0,0,0,1,304,ITH,ITH4,6,Friuli-Venezia Giulia
2021-01-02,UMB,301,110,191,301,0,0,0,0,0,0,301,0,ITI,ITI2,10,Umbria
2021-04-10,CAM,28337,13486,14851,259,52,20805,90,6263,134,734,23422,4915,ITF,ITF3,15,Campania
2021-01-30,PAT,386,132,254,346,7,0,32,0,0,1,152,234,ITH,ITH2,4,Provincia Autonoma Trento
2021-02-20,PAB,1502,471,1031,196,53,30,24,469,1,729,1484,18,ITH,ITH1,4,Provincia Autonoma Bolzano / Bozen
2021-03-05,PAT,2226,700,1526,126,67,45,102,954,158,774,1661,565,ITH,ITH2,4,Provincia Autonoma Trento
2021-01-31,LAZ,4297,1791,2506,3572,139,213,244,129,0,0,314,3983,ITI,ITI4,12,Lazio
2021-01-11,UMB,1281,337,944,878,12,7,384,0,0,0,1281,0,ITI,ITI2,10,Umbria
2021-03-15,PAT,1399,540,859,58,126,345,26,617,52,175,942,457,ITH,ITH2,4,Provincia Autonoma Trento
2021-03-09,UMB,4029,1951,2078,143,549,131,106,2912,165,23,2737,1292,ITI,ITI2,10,Umbria
2021-04-12,UMB,7059,3065,3994,204,15,3912,0,2907,4,17,5341,1718,ITI,ITI2,10,Umbria
2021-02-18,LOM,14036,4925,9111,6162,1801,157,1593,3437,858,28,13009,1027,ITC,ITC4,3,Lombardia
2021-04-12,EMR,18982,8891,10091,437,132,11457,295,6532,67,62,14617,4365,ITH,ITH5,8,Emilia-Romagna
2021-01-07,PAB,916,327,589,617,107,133,0,59,0,0,916,0,ITH,ITH1,4,Provincia Autonoma Bolzano / Bozen
2021-03-29,VEN,31231,13499,17732,606,119,12157,466,17187,254,442,27380,3851,ITH,ITH3,5,Veneto
2021-01-02,VEN,5742,1765,3977,4801,147,245,544,2,0,3,5742,0,ITH,ITH3,5,Veneto
2020-12-31,LOM,713,300,413,657,56,0,0,0,0,0,713,0,ITC,ITC4,3,Lombardia
2021-04-15,BAS,3454,1675,1779,115,3,2570,0,730,1,35,2645,809,ITF,ITF5,17,Basilicata
2021-02-23,MOL,581,223,358,136,39,4,61,340,0,1,362,219,ITF,ITF2,14,Molise
2021-01-27,LAZ,5799,2188,3611,4797,215,191,457,139,0,0,682,5117,ITI,ITI4,12,Lazio
2021-02-28,MAR,2841,1251,1590,19,0,18,0,2800,2,2,2835,6,ITI,ITI3,11,Marche
2021-04-07,FVG,7439,3303,4136,335,294,4651,38,2080,9,32,6654,785,ITH,ITH4,6,Friuli-Venezia Giulia
2021-03-03,TOS,18125,6460,11665,3324,496,663,135,9162,899,3446,14522,3603,ITI,ITI1,9,Toscana
2021-04-18,SIC,19739,9874,9865,243,12,16630,100,2652,8,94,15352,4387,ITG,ITG1,19,Sicilia
2021-01-25,UMB,647,322,325,645,2,0,0,0,0,0,5,642,ITI,ITI2,10,Umbria
2021-04-04,CAM,7941,4001,3940,177,24,5623,6,1984,54,73,6898,1043,ITF,ITF3,15,Campania
2021-04-02,CAL,8078,3689,4389,361,21,3085,597,2764,96,1154,4215,3863,ITF,ITF6,18,Calabria
2021-01-24,PUG,1668,749,919,1286,231,0,150,1,0,0,152,1516,ITF,ITF4,16,Puglia
2021-03-06,PIE,13988,5209,8779,2262,773,357,462,7437,0,2697,11199,2789,ITC,ITC1,1,Piemonte
2021-02-19,EMR,7321,3010,4311,820,198,182,257,5864,0,0,6808,513,ITH,ITH5,8,Emilia-Romagna
2021-02-16,BAS,905,377,528,250,90,5,67,492,1,0,807,98,ITF,ITF5,17,Basilicata
2021-03-13,TOS,9276,3300,5976,2835,1156,953,68,180,344,3740,5314,3962,ITI,ITI1,9,Toscana
2021-02-06,LIG,1891,767,1124,1309,161,45,375,0,0,1,145,1746,ITC,ITC3,7,Liguria
2021-03-21,LOM,23538,8539,14999,1082,552,1899,410,9730,738,9127,18283,5255,ITC,ITC4,3,Lombardia
2021-02-27,BAS,1986,856,1130,103,123,61,21,1678,0,0,1822,164,ITF,ITF5,17,Basilicata
2021-04-04,PIE,9239,4052,5187,197,72,4449,0,4221,6,294,6526,2713,ITC,ITC1,1,Piemonte
2021-02-19,SAR,1496,470,1026,677,336,102,379,1,1,0,1440,56,ITG,ITG2,20,Sardegna
2021-03-16,VEN,12466,5331,7135,1394,106,2627,485,7720,5,129,6856,5610,ITH,ITH3,5,Veneto
2021-03-06,CAM,16303,6749,9554,993,133,1359,172,7133,1027,5486,10636,5667,ITF,ITF3,15,Campania
2021-01-03,PAB,41,16,25,33,5,2,0,1,0,0,41,0,ITH,ITH1,4,Provincia Autonoma Bolzano / Bozen
2021-02-07,SIC,2349,997,1352,1611,109,472,157,0,0,0,675,1674,ITG,ITG1,19,Sicilia
2021-01-13,LIG,2755,1013,1742,1913,227,124,487,0,0,4,2755,0,ITC,ITC3,7,Liguria
2021-03-16,PIE,10517,4267,6250,2229,799,360,322,6794,0,13,4462,6055,ITC,ITC1,1,Piemonte
2021-02-25,VEN,7896,3339,4557,1541,252,292,472,4937,105,297,7294,602,ITH,ITH3,5,Veneto
2021-03-12,PUG,13829,6080,7749,3281,941,382,432,4960,889,2944,9904,3925,ITF,ITF4,16,Puglia
2021-01-05,MOL,449,180,269,441,0,8,0,0,0,0,449,0,ITF,ITF2,14,Molise
2021-02-01,PAT,1220,335,885,767,70,8,375,0,0,0,92,1128,ITH,ITH2,4,Provincia Autonoma Trento
2021-04-05,EMR,14776,6770,8006,280,36,6724,4,7465,24,243,11894,2882,ITH,ITH5,8,Emilia-Romagna
2021-03-26,VEN,29378,12992,16386,1273,378,14446,1214,9830,314,1923,23894,5484,ITH,ITH3,5,Veneto
2021-04-05,SAR,2030,781,1249,55,35,1086,0,144,16,694,2028,2,ITG,ITG2,20,Sardegna
2021-03-12,PAT,2476,927,1549,207,252,50,106,1106,203,552,1672,804,ITH,ITH2,4,Provincia Autonoma Trento
2021-01-07,PUG,5713,2454,3259,5216,253,17,217,0,7,3,5713,0,ITF,ITF4,16,Puglia
2021-01-25,FVG,1583,567,1016,1370,0,141,72,0,0,0,194,1389,ITH,ITH4,6,Friuli-Venezia Giulia
2021-02-03,MOL,731,249,482,391,110,49,180,0,0,1,338,393,ITF,ITF2,14,Molise
2021-01-26,PAB,810,291,519,673,129,8,0,0,0,0,1,809,ITH,ITH1,4,Provincia Autonoma Bolzano / Bozen
2021-02-17,BAS,1135,493,642,123,42,27,57,884,1,1,1059,76,ITF,ITF5,17,Basilicata
2020-12-27,PIE,913,369,544,761,65,11,76,0,0,0,913,0,ITC,ITC1,1,Piemonte
2021-02-04,BAS,1092,440,652,636,106,69,281,0,0,0,63,1029,ITF,ITF5,17,Basilicata
2021-01-22,PIE,3864,1248,2616,2280,609,41,934,0,0,0,2523,1341,ITC,ITC1,1,Piemonte
2021-01-07,PAT,1270,310,960,649,46,18,557,0,0,0,1270,0,ITH,ITH2,4,Provincia Autonoma Trento
2021-04-13,LIG,12481,5587,6894,512,72,7382,111,4231,70,103,10575,1906,ITC,ITC3,7,Liguria
2021-01-07,ABR,1603,552,1051,1566,0,37,0,0,0,0,1603,0,ITF,ITF1,13,Abruzzo
2021-02-15,VDA,264,136,128,24,2,26,25,170,15,2,229,35,ITC,ITC2,2,Valle d'Aosta / Vallée d'Aoste
2021-04-04,LOM,7561,3214,4347,204,227,998,68,5851,8,205,3666,3895,ITC,ITC4,3,Lombardia
2021-01-03,LIG,734,230,504,658,23,52,0,0,0,1,734,0,ITC,ITC3,7,Liguria
2021-01-18,LAZ,5919,2323,3596,3905,387,415,725,487,0,0,4941,978,ITI,ITI4,12,Lazio
2021-02-23,FVG,2615,1252,1363,104,44,63,206,1943,254,1,2437,178,ITH,ITH4,6,Friuli-Venezia Giulia
2021-01-18,TOS,1119,636,483,430,313,1,375,0,0,0,1021,98,ITI,ITI1,9,Toscana
2021-02-26,FVG,3740,2094,1646,75,26,115,453,1739,1033,299,3593,147,ITH,ITH4,6,Friuli-Venezia Giulia
2021-04-07,MAR,7798,3432,4366,189,2,5292,13,1305,24,973,7462,336,ITI,ITI3,11,Marche
2021-02-10,TOS,4264,1281,2983,3536,239,2,485,1,1,0,3740,524,ITI,ITI1,9,Toscana
2021-03-26,PAB,1631,716,915,20,14,622,68,906,0,1,509,1122,ITH,ITH1,4,Provincia Autonoma Bolzano / Bozen
2021-02-19,VEN,7297,3124,4173,1545,175,534,665,4366,3,9,7095,202,ITH,ITH3,5,Veneto
2021-04-04,UMB,59,20,39,0,0,22,0,37,0,0,23,36,ITI,ITI2,10,Umbria
2021-02-22,PUG,9616,4524,5092,1438,447,255,140,6802,215,319,9285,331,ITF,ITF4,16,Puglia
2021-01-19,MOL,173,63,110,90,57,2,22,0,0,2,162,11,ITF,ITF2,14,Molise
2021-01-06,VEN,8133,2386,5747,6351,170,790,808,2,2,10,8133,0,ITH,ITH3,5,Veneto
2021-03-03,CAM,13916,5492,8424,2088,234,2459,156,4744,3,4232,7287,6629,ITF,ITF3,15,Campania
2021-03-28,VDA,520,212,308,51,6,352,0,52,13,46,519,1,ITC,ITC2,2,Valle d'Aosta / Vallée d'Aoste
2020-12-29,SAR,57,32,25,56,1,0,0,0,0,0,57,0,ITG,ITG2,20,Sardegna
2020-12-29,LOM,104,44,60,103,1,0,0,0,0,0,104,0,ITC,ITC4,3,Lombardia
2021-03-31,BAS,3238,1288,1950,68,0,257,0,2664,18,231,2454,784,ITF,ITF5,17,Basilicata
2021-02-08,PUG,3991,1609,2382,2964,584,27,389,1,25,1,1597,2394,ITF,ITF4,16,Puglia
2021-01-11,MAR,1176,411,765,1021,2,153,0,0,0,0,1176,0,ITI,ITI3,11,Marche
2021-03-12,PIE,13899,5152,8747,2142,855,482,472,7611,63,2274,10965,2934,ITC,ITC1,1,Piemonte
2021-01-27,TOS,4834,1572,3262,4018,73,1,742,0,0,0,207,4627,ITI,ITI1,9,Toscana
2021-03-05,LOM,28925,11926,16999,7226,2558,4212,1548,11058,1900,423,20530,8395,ITC,ITC4,3,Lombardia
2021-02-21,EMR,4425,1700,2725,395,98,186,190,3556,0,0,3985,440,ITH,ITH5,8,Emilia-Romagna
2021-01-07,CAL,2180,1061,1119,1883,0,297,0,0,0,0,2180,0,ITF,ITF6,18,Calabria
2021-03-30,LAZ,24962,11447,13515,3782,86,11224,248,9113,221,288,17868,7094,ITI,ITI4,12,Lazio
2021-03-21,CAL,4364,1883,2481,135,0,1128,200,2127,29,745,2662,1702,ITF,ITF6,18,Calabria
2021-04-08,SIC,17012,8389,8623,699,146,11621,473,3833,82,158,8494,8518,ITG,ITG1,19,Sicilia
2021-02-27,PAT,1024,455,569,459,5,9,0,434,4,113,604,420,ITH,ITH2,4,Provincia Autonoma Trento
2021-03-16,SAR,4367,1945,2422,663,180,648,340,2528,0,8,3445,922,ITG,ITG2,20,Sardegna
2021-04-17,CAM,36121,17483,18638,217,35,29015,7,6315,102,430,24601,11520,ITF,ITF3,15,Campania
2021-04-15,LAZ,30819,13873,16946,3836,92,17954,332,8504,26,75,20235,10584,ITI,ITI4,12,Lazio
2021-03-02,SIC,14957,6389,8568,2383,98,1831,501,4471,1339,4334,12132,2825,ITG,ITG1,19,Sicilia
2021-04-12,FVG,7112,3132,3980,274,175,4349,230,2060,4,20,6026,1086,ITH,ITH4,6,Friuli-Venezia Giulia
2021-04-16,LIG,11572,5094,6478,478,123,7362,66,3436,65,42,9781,1791,ITC,ITC3,7,Liguria
2021-03-16,PAB,776,308,468,25,30,39,48,634,0,0,123,653,ITH,ITH1,4,Provincia Autonoma Bolzano / Bozen
2021-01-09,ABR,1483,565,918,1430,0,53,0,0,0,0,1483,0,ITF,ITF1,13,Abruzzo
2021-01-08,ABR,1525,507,1018,1487,0,38,0,0,0,0,1525,0,ITF,ITF1,13,Abruzzo
2021-02-01,PUG,3961,1657,2304,3443,286,13,208,0,6,5,375,3586,ITF,ITF4,16,Puglia
2021-01-06,BAS,294,129,165,229,9,20,36,0,0,0,294,0,ITF,ITF5,17,Basilicata
2021-02-14,VEN,125,56,69,97,1,27,0,0,0,0,112,13,ITH,ITH3,5,Veneto
2021-01-19,LIG,1364,433,931,714,133,186,328,0,0,3,1274,90,ITC,ITC3,7,Liguria
2021-03-26,SAR,7993,3134,4859,842,254,2085,413,2728,151,1520,6472,1521,ITG,ITG2,20,Sardegna
2021-03-10,CAM,15240,7374,7866,704,240,2311,26,8433,1058,2468,8411,6829,ITF,ITF3,15,Campania
2021-01-15,MOL,538,242,296,398,17,42,81,0,0,0,538,0,ITF,ITF2,14,Molise
2021-02-20,PAT,406,245,161,330,10,1,30,1,3,31,122,284,ITH,ITH2,4,Provincia Autonoma Trento
2021-01-04,MOL,314,131,183,301,0,13,0,0,0,0,314,0,ITF,ITF2,14,Molise
2021-03-21,FVG,2600,937,1663,6,3,112,0,1333,27,1119,2192,408,ITH,ITH4,6,Friuli-Venezia Giulia
2021-02-06,MOL,429,179,250,276,13,9,130,0,0,1,29,400,ITF,ITF2,14,Molise
2021-01-30,LIG,1661,567,1094,1261,88,53,257,0,0,2,25,1636,ITC,ITC3,7,Liguria
2021-04-16,MOL,2354,1010,1344,54,3,1554,6,722,7,8,1146,1208,ITF,ITF2,14,Molise
2021-04-18,PIE,22128,10469,11659,305,196,17219,4,4350,8,46,19377,2751,ITC,ITC1,1,Piemonte
2021-02-18,ABR,2291,934,1357,670,36,344,416,610,215,0,2161,130,ITF,ITF1,13,Abruzzo
2021-02-25,UMB,1335,496,839,827,96,3,99,305,0,5,1283,52,ITI,ITI2,10,Umbria
2021-01-28,MAR,1973,659,1314,1581,0,291,101,0,0,0,167,1806,ITI,ITI3,11,Marche
2021-02-14,SAR,539,263,276,286,187,6,57,3,0,0,537,2,ITG,ITG2,20,Sardegna
2021-03-25,SIC,20495,9539,10956,1325,76,11524,582,5526,82,1380,14954,5541,ITG,ITG1,19,Sicilia
2021-02-19,ABR,3301,1552,1749,990,32,401,371,1111,388,8,3201,100,ITF,ITF1,13,Abruzzo
2021-02-20,PUG,2966,1078,1888,2115,195,50,168,9,4,425,2710,256,ITF,ITF4,16,Puglia
2021-03-25,LAZ,26405,11264,15141,4807,84,8039,318,9474,199,3484,20091,6314,ITI,ITI4,12,Lazio
2021-03-15,VEN,16520,7192,9328,1386,37,3365,372,9243,148,1969,11305,5215,ITH,ITH3,5,Veneto
2021-01-14,PAT,699,203,496,482,6,3,208,0,0,0,699,0,ITH,ITH2,4,Provincia Autonoma Trento
2021-01-12,CAM,5214,2563,2651,3439,722,713,340,0,0,0,5214,0,ITF,ITF3,15,Campania
2021-01-08,LIG,2926,999,1927,2083,167,240,431,0,1,4,2926,0,ITC,ITC3,7,Liguria
2021-04-02,CAM,21746,10412,11334,263,43,16023,105,3964,285,1063,19428,2318,ITF,ITF3,15,Campania
2021-03-19,EMR,15259,6625,8634,1125,292,2382,116,10407,601,336,7499,7760,ITH,ITH5,8,Emilia-Romagna
2021-03-17,ABR,4545,1876,2669,285,26,187,144,3875,17,11,2802,1743,ITF,ITF1,13,Abruzzo
2021-02-05,PIE,9451,3078,6373,5766,1959,82,1643,1,0,0,657,8794,ITC,ITC1,1,Piemonte
2021-02-19,CAM,9555,3556,5999,1663,141,943,161,4454,0,2193,8905,650,ITF,ITF3,15,Campania
2021-02-10,LAZ,7832,3143,4689,2647,275,330,634,3946,0,0,4841,2991,ITI,ITI4,12,Lazio
2021-03-09,VEN,16430,7370,9060,1288,143,2503,741,8546,261,2948,10144,6286,ITH,ITH3,5,Veneto
2021-02-20,TOS,4641,1790,2851,3350,1038,0,203,17,15,18,4128,513,ITI,ITI1,9,Toscana
2021-04-05,PIE,14736,6233,8503,148,49,5829,0,7981,26,703,12174,2562,ITC,ITC1,1,Piemonte
2021-02-28,ABR,1708,511,1197,23,0,34,0,79,149,1423,1706,2,ITF,ITF1,13,Abruzzo
2021-03-11,PAB,1681,823,858,89,97,482,72,367,239,335,1143,538,ITH,ITH1,4,Provincia Autonoma Bolzano / Bozen
2021-03-10,BAS,1650,814,836,101,46,64,33,877,256,273,811,839,ITF,ITF5,17,Basilicata
2021-01-13,MOL,474,160,314,256,66,7,144,0,0,1,474,0,ITF,ITF2,14,Molise
2021-01-26,BAS,793,350,443,622,70,66,35,0,0,0,101,692,ITF,ITF5,17,Basilicata
2021-03-25,MAR,6657,2774,3883,464,12,947,365,4307,43,519,3247,3410,ITI,ITI3,11,Marche
2021-03-05,PUG,17022,6777,10245,2307,571,618,273,5231,1022,7000,14861,2161,ITF,ITF4,16,Puglia
2021-01-08,LOM,12664,3910,8754,9964,2175,143,376,6,0,0,12664,0,ITC,ITC4,3,Lombardia
2021-01-30,PUG,5525,2513,3012,4749,324,20,419,3,4,6,411,5114,ITF,ITF4,16,Puglia
2021-03-23,SIC,21058,10105,10953,880,41,11992,365,5827,306,1647,15450,5608,ITG,ITG1,19,Sicilia
2021-01-19,TOS,1104,531,573,392,220,1,491,0,0,0,1104,0,ITI,ITI1,9,Toscana
2021-03-20,VDA,205,85,120,5,2,164,15,14,4,1,170,35,ITC,ITC2,2,Valle d'Aosta / Vallée d'Aoste
2021-01-31,BAS,77,24,53,75,2,0,0,0,0,0,0,77,ITF,ITF5,17,Basilicata
2021-03-29,SAR,4371,1541,2830,624,209,844,182,1013,88,1411,3785,586,ITG,ITG2,20,Sardegna
2021-02-20,PIE,3829,1252,2577,1100,395,669,219,30,0,1416,3656,173,ITC,ITC1,1,Piemonte
2021-01-01,CAM,919,506,413,831,85,3,0,0,0,0,919,0,ITF,ITF3,15,Campania
2021-01-23,ABR,264,114,150,224,0,14,26,0,0,0,57,207,ITF,ITF1,13,Abruzzo
2021-02-20,UMB,282,100,182,83,7,1,39,152,0,0,258,24,ITI,ITI2,10,Umbria
2021-03-26,CAM,19454,8929,10525,363,36,9425,142,7621,232,1635,15644,3810,ITF,ITF3,15,Campania
2021-01-31,SIC,4113,1959,2154,2602,117,1099,295,0,0,0,114,3999,ITG,ITG1,19,Sicilia
2021-04-09,VDA,233,110,123,0,0,198,7,28,0,0,200,33,ITC,ITC2,2,Valle d'Aosta / Vallée d'Aoste
2021-01-02,SAR,60,21,39,60,0,0,0,0,0,0,60,0,ITG,ITG2,20,Sardegna
2021-02-09,ABR,908,311,597,612,56,109,131,0,0,0,499,409,ITF,ITF1,13,Abruzzo
2021-03-08,BAS,1450,707,743,221,126,126,38,410,256,273,840,610,ITF,ITF5,17,Basilicata
2021-02-27,FVG,3424,1178,2246,203,140,32,0,1523,25,1501,3423,1,ITH,ITH4,6,Friuli-Venezia Giulia
2021-01-21,PAT,351,94,257,320,13,2,16,0,0,0,228,123,ITH,ITH2,4,Provincia Autonoma Trento
2021-02-01,TOS,5508,1958,3550,4485,403,4,616,0,0,0,520,4988,ITI,ITI1,9,Toscana
2021-02-02,MOL,539,176,363,295,64,0,180,0,0,0,216,323,ITF,ITF2,14,Molise
2021-02-04,ABR,1682,617,1065,1168,47,410,57,0,0,0,609,1073,ITF,ITF1,13,Abruzzo
2021-02-25,LAZ,12639,5514,7125,1754,434,776,489,5152,1423,2611,11591,1048,ITI,ITI4,12,Lazio
2021-03-09,SAR,5150,2371,2779,1056,368,528,285,2271,332,310,4421,729,ITG,ITG2,20,Sardegna
2021-02-09,LOM,12241,3328,8913,5736,2207,92,4125,75,2,4,4109,8132,ITC,ITC4,3,Lombardia
2021-04-06,LOM,42540,17370,25170,2149,1409,6061,617,27659,125,4520,24760,17780,ITC,ITC4,3,Lombardia
2021-03-26,PIE,17724,6974,10750,1162,452,1416,527,11518,221,2428,8820,8904,ITC,ITC1,1,Piemonte
2021-03-15,PUG,11744,5606,6138,2091,563,271,115,7666,356,682,5254,6490,ITF,ITF4,16,Puglia
2021-02-06,TOS,4527,1550,2977,3725,574,1,227,0,0,0,1294,3233,ITI,ITI1,9,Toscana
2021-01-03,TOS,3336,1052,2284,2565,9,0,762,0,0,0,3336,0,ITI,ITI1,9,Toscana
2021-01-29,BAS,613,229,384,398,38,107,70,0,0,0,63,550,ITF,ITF5,17,Basilicata
2021-03-03,PUG,16461,6606,9855,1990,454,383,192,5929,809,6704,14638,1823,ITF,ITF4,16,Puglia
2021-03-29,ABR,5626,2525,3101,463,1,1297,42,3593,35,195,2986,2640,ITF,ITF1,13,Abruzzo
2021-04-17,PAB,5225,2596,2629,69,9,4918,35,99,20,75,5177,48,ITH,ITH1,4,Provincia Autonoma Bolzano / Bozen
2021-04-13,TOS,8341,3446,4895,250,300,2137,266,5353,30,5,5928,2413,ITI,ITI1,9,Toscana
2021-03-05,EMR,17600,5726,11874,3079,621,879,254,6296,531,5940,14189,3411,ITH,ITH5,8,Emilia-Romagna
2021-03-15,LOM,31371,11241,20130,4682,2160,1856,880,12885,594,8314,22895,8476,ITC,ITC4,3,Lombardia
2021-01-18,CAM,957,399,558,576,93,101,187,0,0,0,713,244,ITF,ITF3,15,Campania
2021-02-23,SAR,1519,1010,509,602,191,328,89,8,301,0,1285,234,ITG,ITG2,20,Sardegna
2021-03-13,CAM,14254,6793,7461,404,82,1879,193,6613,1397,3686,8969,5285,ITF,ITF3,15,Campania
2021-03-26,FVG,5766,2412,3354,496,195,2063,124,2050,87,751,3751,2015,ITH,ITH4,6,Friuli-Venezia Giulia
2021-02-26,TOS,10063,3824,6239,1557,637,1069,298,1802,1138,3562,8857,1206,ITI,ITI1,9,Toscana
2021-02-22,CAM,10662,3291,7371,544,46,492,142,3896,0,5542,10399,263,ITF,ITF3,15,Campania
2021-04-04,CAL,1735,875,860,34,0,1110,22,502,0,67,1236,499,ITF,ITF6,18,Calabria
2021-01-30,EMR,10068,3516,6552,7564,715,993,796,0,0,0,142,9926,ITH,ITH5,8,Emilia-Romagna
2021-01-13,PUG,4537,1729,2808,3973,313,19,230,0,0,2,4537,0,ITF,ITF4,16,Puglia
2021-02-03,PAB,1503,478,1025,666,341,107,321,68,0,0,5,1498,ITH,ITH1,4,Provincia Autonoma Bolzano / Bozen
2021-04-19,FVG,3176,1584,1592,76,50,2310,1,727,2,10,1264,1912,ITH,ITH4,6,Friuli-Venezia Giulia
2021-01-07,FVG,2092,718,1374,1760,1,221,110,0,0,0,2092,0,ITH,ITH4,6,Friuli-Venezia Giulia
2021-02-05,VEN,8367,2533,5834,4298,679,1202,2163,7,5,13,1423,6944,ITH,ITH3,5,Veneto
2021-04-02,LOM,40563,16571,23992,2527,1383,6494,1067,24335,119,4638,26304,14259,ITC,ITC4,3,Lombardia
2021-03-07,PUG,4912,1939,2973,930,48,135,2,1621,324,1852,4342,570,ITF,ITF4,16,Puglia
2021-03-19,ABR,5796,2584,3212,755,28,432,118,4399,51,13,2775,3021,ITF,ITF1,13,Abruzzo
2021-01-07,SAR,3111,1077,2034,2720,311,69,0,0,11,0,3111,0,ITG,ITG2,20,Sardegna
2021-02-25,CAL,2821,1519,1302,736,49,587,234,863,348,4,2242,579,ITF,ITF6,18,Calabria
2021-04-19,PUG,13868,6430,7438,386,30,11552,32,1836,12,20,11891,1977,ITF,ITF4,16,Puglia
2021-04-05,PAT,33,16,17,0,0,32,0,0,0,1,33,0,ITH,ITH2,4,Provincia Autonoma Trento
2020-12-28,SAR,65,25,40,65,0,0,0,0,0,0,65,0,ITG,ITG2,20,Sardegna
2021-03-04,FVG,3425,1591,1834,357,212,39,96,1815,504,402,2783,642,ITH,ITH4,6,Friuli-Venezia Giulia
2021-03-02,LAZ,16635,7202,9433,1811,357,1085,229,8121,1278,3754,12705,3930,ITI,ITI4,12,Lazio
2021-01-13,SAR,573,178,395,494,76,3,0,0,0,0,573,0,ITG,ITG2,20,Sardegna
2021-03-28,BAS,2147,745,1402,92,0,72,1,1268,2,712,2125,22,ITF,ITF5,17,Basilicata
2021-02-15,ABR,1796,831,965,625,30,457,221,217,246,0,1754,42,ITF,ITF1,13,Abruzzo
2021-03-21,SAR,4030,1809,2221,64,5,404,0,2880,102,575,2590,1440,ITG,ITG2,20,Sardegna
2020-12-29,LIG,125,33,92,93,11,0,21,0,0,0,125,0,ITC,ITC3,7,Liguria
2021-02-19,LOM,14092,5364,8728,5561,1629,270,1148,4540,928,16,13410,682,ITC,ITC4,3,Lombardia
2021-01-10,LAZ,4039,1700,2339,3424,156,207,252,0,0,0,4039,0,ITI,ITI4,12,Lazio
2021-02-24,BAS,1803,743,1060,85,9,20,2,1686,1,0,1734,69,ITF,ITF5,17,Basilicata
2021-02-23,PUG,9332,4411,4921,1787,347,108,169,5506,398,1017,8859,473,ITF,ITF4,16,Puglia
2021-01-19,PIE,6423,2099,4324,3575,1239,61,1548,0,0,0,6414,9,ITC,ITC1,1,Piemonte
2021-01-19,UMB,103,23,80,21,2,0,80,0,0,0,103,0,ITI,ITI2,10,Umbria
2021-04-15,PIE,28275,12969,15306,862,365,20154,304,6535,4,51,22879,5396,ITC,ITC1,1,Piemonte
2021-03-16,CAL,3777,1850,1927,460,5,1121,22,2081,58,30,2179,1598,ITF,ITF6,18,Calabria
2021-01-06,CAM,7652,3749,3903,5781,838,733,300,0,0,0,7652,0,ITF,ITF3,15,Campania
2021-01-12,LOM,19842,6612,13230,13434,4451,235,1627,94,1,0,19842,0,ITC,ITC4,3,Lombardia
2021-03-26,LIG,9094,3843,5251,602,182,2751,65,3881,316,1297,5940,3154,ITC,ITC3,7,Liguria
2021-04-15,CAM,34247,16627,17620,312,38,27363,21,6134,68,311,24375,9872,ITF,ITF3,15,Campania
2020-12-27,CAL,275,150,125,274,0,1,0,0,0,0,275,0,ITF,ITF6,18,Calabria
2021-03-31,SAR,10069,4030,6039,396,103,2962,228,4986,16,1378,7620,2449,ITG,ITG2,20,Sardegna
2021-01-22,ABR,118,57,61,2,1,3,112,0,0,0,118,0,ITF,ITF1,13,Abruzzo
2021-01-05,LIG,2879,896,1983,2309,107,195,261,0,0,7,2879,0,ITC,ITC3,7,Liguria
2021-04-17,SAR,8791,3946,4845,291,70,4978,108,3318,2,24,4731,4060,ITG,ITG2,20,Sardegna
2021-02-03,MAR,2125,742,1383,1344,2,613,166,0,0,0,119,2006,ITI,ITI3,11,Marche
2021-04-01,LIG,11982,5295,6687,435,63,6578,139,3693,138,936,9212,2770,ITC,ITC3,7,Liguria
2021-02-26,ABR,3920,1671,2249,1025,13,552,160,1651,257,262,2951,969,ITF,ITF1,13,Abruzzo
2021-02-12,PUG,4098,1629,2469,2938,440,10,690,5,10,5,3008,1090,ITF,ITF4,16,Puglia
2021-04-06,MOL,1462,688,774,33,2,1174,9,238,5,1,1119,343,ITF,ITF2,14,Molise
2021-01-22,LOM,3095,863,2232,1580,599,34,873,9,0,0,3025,70,ITC,ITC4,3,Lombardia
2021-01-15,MAR,1771,500,1271,985,60,360,366,0,0,0,1771,0,ITI,ITI3,11,Marche
2021-01-30,VDA,437,202,235,232,181,12,12,0,0,0,14,423,ITC,ITC2,2,Valle d'Aosta / Vallée d'Aoste
2021-04-11,BAS,847,330,517,74,0,499,0,46,3,225,786,61,ITF,ITF5,17,Basilicata
2021-02-12,ABR,968,319,649,438,11,209,310,0,0,0,779,189,ITF,ITF1,13,Abruzzo
2021-03-18,CAL,4246,1979,2267,360,49,1320,232,2196,44,45,2277,1969,ITF,ITF6,18,Calabria
2021-03-12,LOM,35179,12932,22247,5109,2153,1895,1492,16057,1086,7387,24981,10198,ITC,ITC4,3,Lombardia
2021-01-29,SAR,2951,1067,1884,2580,226,142,3,0,0,0,48,2903,ITG,ITG2,20,Sardegna
2021-03-09,PIE,13938,5417,8521,1688,849,708,356,8006,1,2330,11596,2342,ITC,ITC1,1,Piemonte
2020-12-27,CAM,720,422,298,703,14,3,0,0,0,0,720,0,ITF,ITF3,15,Campania
2021-03-20,PUG,8219,3716,4503,1423,67,237,54,5594,36,808,3642,4577,ITF,ITF4,16,Puglia
2021-03-19,CAL,4186,1947,2239,486,5,1327,293,1965,8,102,1900,2286,ITF,ITF6,18,Calabria
2021-03-06,ABR,4174,1354,2820,432,24,344,52,1748,15,1559,3604,570,ITF,ITF1,13,Abruzzo
2021-01-14,VDA,237,69,168,151,62,22,0,2,0,0,237,0,ITC,ITC2,2,Valle d'Aosta / Vallée d'Aoste
2021-01-27,PUG,4576,1928,2648,3932,226,20,396,0,0,2,611,3965,ITF,ITF4,16,Puglia
2021-04-17,EMR,26086,12482,13604,387,100,21471,64,3995,16,53,17209,8877,ITH,ITH5,8,Emilia-Romagna
2021-03-03,SAR,3834,2061,1773,1070,275,444,600,703,741,1,2607,1227,ITG,ITG2,20,Sardegna
2021-02-27,PIE,12678,4846,7832,885,465,517,232,7541,0,3038,12331,347,ITC,ITC1,1,Piemonte
2021-03-15,SIC,10765,4725,6040,1241,48,2608,666,4831,217,1154,5692,5073,ITG,ITG1,19,Sicilia
2021-01-12,ABR,1804,666,1138,1470,42,292,0,0,0,0,1804,0,ITF,ITF1,13,Abruzzo
2021-01-08,MOL,429,141,288,244,6,59,120,0,0,0,429,0,ITF,ITF2,14,Molise
2021-03-01,VEN,9386,3710,5676,2047,145,970,954,2610,141,2519,7564,1822,ITH,ITH3,5,Veneto
2021-03-20,PIE,11912,4896,7016,882,449,799,163,7682,0,1937,6016,5896,ITC,ITC1,1,Piemonte
2021-02-08,LOM,9886,2875,7011,5245,2177,70,2341,53,0,0,2137,7749,ITC,ITC4,3,Lombardia
2021-01-09,SAR,4026,1417,2609,3182,602,242,0,0,0,0,4026,0,ITG,ITG2,20,Sardegna
2021-02-21,MOL,573,227,346,1,0,4,0,568,0,0,571,2,ITF,ITF2,14,Molise
2021-02-20,FVG,2068,933,1135,11,1,18,148,1584,0,306,1924,144,ITH,ITH4,6,Friuli-Venezia Giulia
2021-01-28,SIC,9330,4400,4930,7466,221,1348,295,0,0,0,414,8916,ITG,ITG1,19,Sicilia
2021-03-14,MOL,595,239,356,2,0,11,0,582,0,0,17,578,ITF,ITF2,14,Molise
2021-02-17,PIE,4787,2154,2633,2245,954,1089,497,1,0,1,3798,989,ITC,ITC1,1,Piemonte
2021-01-24,LAZ,5546,2149,3397,4945,131,188,134,148,0,0,464,5082,ITI,ITI4,12,Lazio
2021-03-08,CAL,5323,2822,2501,708,25,1794,453,1517,823,3,4265,1058,ITF,ITF6,18,Calabria
2021-03-14,UMB,66,48,18,0,6,55,1,0,0,4,66,0,ITI,ITI2,10,Umbria
2021-01-21,BAS,30,10,20,0,0,30,0,0,0,0,30,0,ITF,ITF5,17,Basilicata
2021-02-16,VEN,6631,2868,3763,726,109,294,478,5020,1,3,6452,179,ITH,ITH3,5,Veneto
2021-01-29,CAL,2048,984,1064,1752,4,243,49,0,0,0,234,1814,ITF,ITF6,18,Calabria
2021-02-17,VEN,6020,2771,3249,423,19,262,361,4946,5,4,5926,94,ITH,ITH3,5,Veneto
2021-03-16,CAM,8087,3519,4568,289,53,679,60,6869,23,114,3772,4315,ITF,ITF3,15,Campania
2021-01-22,TOS,2865,1064,1801,2026,81,0,758,0,0,0,527,2338,ITI,ITI1,9,Toscana
2021-02-12,TOS,7606,2683,4923,3742,380,2892,188,2,402,0,7393,213,ITI,ITI1,9,Toscana
2021-04-03,CAM,21129,10321,10808,203,46,15487,185,4491,159,558,18754,2375,ITF,ITF3,15,Campania
2021-03-08,LAZ,19897,8230,11667,2452,120,2076,380,9058,1102,4709,14632,5265,ITI,ITI4,12,Lazio
2021-02-13,PIE,4152,1334,2818,2310,655,67,1114,1,0,5,2931,1221,ITC,ITC1,1,Piemonte
2021-01-18,PIE,6164,2047,4117,3238,1322,81,1523,0,0,0,5916,248,ITC,ITC1,1,Piemonte
2021-01-21,ABR,157,47,110,10,4,2,141,0,0,0,157,0,ITF,ITF1,13,Abruzzo
2021-01-13,VEN,5986,1607,4379,2795,430,868,1888,3,0,2,5986,0,ITH,ITH3,5,Veneto
2021-04-16,PAB,2948,1418,1530,194,34,2531,5,114,32,38,2437,511,ITH,ITH1,4,Provincia Autonoma Bolzano / Bozen
2021-03-21,VEN,11977,4753,7224,1571,51,3510,42,4243,31,2529,8518,3459,ITH,ITH3,5,Veneto
2021-01-09,VDA,443,199,244,225,183,13,22,0,0,0,443,0,ITC,ITC2,2,Valle d'Aosta / Vallée d'Aoste
2021-03-12,LIG,6027,2769,3258,1205,218,714,84,3365,437,4,3562,2465,ITC,ITC3,7,Liguria
2021-03-28,ABR,2418,1019,1399,247,0,884,1,877,234,175,2046,372,ITF,ITF1,13,Abruzzo
2021-02-05,PAB,3192,1179,2013,760,504,399,441,1088,0,0,8,3184,ITH,ITH1,4,Provincia Autonoma Bolzano / Bozen
2021-02-21,MAR,377,142,235,204,1,114,57,0,0,1,376,1,ITI,ITI3,11,Marche
2021-04-19,PAT,2037,947,1090,27,8,1742,0,257,1,2,2014,23,ITH,ITH2,4,Provincia Autonoma Trento
2021-02-06,UMB,396,138,258,333,47,0,16,0,0,0,34,362,ITI,ITI2,10,Umbria
2021-04-10,LIG,7416,3371,4045,213,50,5797,34,1308,5,9,6747,669,ITC,ITC3,7,Liguria
2021-04-14,PAT,3088,1458,1630,115,50,1906,6,1002,2,7,2363,725,ITH,ITH2,4,Provincia Autonoma Trento
2021-04-02,LIG,11309,4959,6350,432,118,6118,31,3611,102,897,8823,2486,ITC,ITC3,7,Liguria
2021-01-03,PIE,3062,966,2096,2715,268,27,52,0,0,0,3062,0,ITC,ITC1,1,Piemonte
2021-03-14,SIC,8825,3947,4878,569,42,3043,176,4281,36,678,4967,3858,ITG,ITG1,19,Sicilia
2021-02-26,UMB,660,253,407,386,73,0,40,154,4,3,652,8,ITI,ITI2,10,Umbria
2021-01-01,LOM,24,7,17,24,0,0,0,0,0,0,24,0,ITC,ITC4,3,Lombardia
2021-04-08,LAZ,26145,11921,14224,4592,80,13542,186,7558,135,52,18520,7625,ITI,ITI4,12,Lazio
2021-03-11,VEN,19576,8667,10909,1653,139,3604,888,9321,285,3686,13994,5582,ITH,ITH3,5,Veneto
2021-01-07,VEN,8359,2318,6041,5470,461,587,1804,35,0,2,8359,0,ITH,ITH3,5,Veneto
2021-01-04,PIE,5563,1679,3884,4590,717,21,235,0,0,0,5563,0,ITC,ITC1,1,Piemonte
2021-01-04,UMB,809,397,412,809,0,0,0,0,0,0,809,0,ITI,ITI2,10,Umbria
2021-03-25,VDA,386,154,232,10,0,122,1,252,0,1,377,9,ITC,ITC2,2,Valle d'Aosta / Vallée d'Aoste
2021-02-11,CAL,2341,1043,1298,1464,71,565,241,0,0,0,1081,1260,ITF,ITF6,18,Calabria
2021-01-16,LIG,1278,557,721,753,62,163,299,0,0,1,1278,0,ITC,ITC3,7,Liguria
2021-02-07,VDA,292,120,172,110,55,17,0,105,2,3,190,102,ITC,ITC2,2,Valle d'Aosta / Vallée d'Aoste
2021-04-10,PAB,5389,2664,2725,146,53,4613,2,541,12,22,4801,588,ITH,ITH1,4,Provincia Autonoma Bolzano / Bozen
2021-04-18,MOL,553,254,299,0,0,275,0,277,0,1,104,449,ITF,ITF2,14,Molise
2021-02-23,PAT,1108,395,713,272,13,2,17,751,3,50,897,211,ITH,ITH2,4,Provincia Autonoma Trento
2021-04-04,LIG,756,366,390,30,0,401,0,325,0,0,507,249,ITC,ITC3,7,Liguria
2021-02-21,VDA,18,3,15,0,0,0,18,0,0,0,0,18,ITC,ITC2,2,Valle d'Aosta / Vallée d'Aoste
2021-04-10,UMB,7423,3492,3931,81,5,6560,30,686,11,50,7309,114,ITI,ITI2,10,Umbria
2021-02-26,SAR,2797,1107,1690,1224,509,561,221,203,74,5,2491,306,ITG,ITG2,20,Sardegna
2021-01-20,LAZ,4449,1687,2762,3280,233,193,427,316,0,0,2908,1541,ITI,ITI4,12,Lazio
2021-03-12,CAM,14247,7095,7152,1022,152,2028,82,6592,1569,2802,8164,6083,ITF,ITF3,15,Campania
2021-02-06,PAB,2626,1171,1455,452,43,580,6,1544,0,1,18,2608,ITH,ITH1,4,Provincia Autonoma Bolzano / Bozen
2021-04-17,TOS,19850,8890,10960,502,373,13553,68,5347,6,1,17876,1974,ITI,ITI1,9,Toscana
2021-01-02,MAR,453,139,314,444,0,9,0,0,0,0,453,0,ITI,ITI3,11,Marche
2021-03-20,BAS,1286,566,720,45,68,47,0,943,5,178,275,1011,ITF,ITF5,17,Basilicata
2021-03-24,MOL,1630,658,972,77,1,348,0,707,47,450,1228,402,ITF,ITF2,14,Molise
2021-01-08,VEN,9402,2834,6568,5988,590,1001,1807,3,1,12,9402,0,ITH,ITH3,5,Veneto
2021-03-01,BAS,540,279,261,121,50,79,4,169,67,50,376,164,ITF,ITF5,17,Basilicata
2021-04-09,MOL,2295,1240,1055,33,4,2143,1,112,1,1,2104,191,ITF,ITF2,14,Molise
2021-04-01,PAB,2782,1405,1377,238,95,1708,43,598,35,65,2638,144,ITH,ITH1,4,Provincia Autonoma Bolzano / Bozen
2021-01-21,FVG,895,345,550,864,0,31,0,0,0,0,1,894,ITH,ITH4,6,Friuli-Venezia Giulia
2021-03-21,CAM,9984,4593,5391,168,27,4973,17,2934,188,1677,7595,2389,ITF,ITF3,15,Campania
2021-03-08,CAM,14536,6715,7821,888,245,2179,70,4863,1334,4957,9760,4776,ITF,ITF3,15,Campania
2021-02-23,CAM,10989,3384,7605,520,85,401,289,3755,0,5939,10463,526,ITF,ITF3,15,Campania
2021-02-25,MOL,541,239,302,68,3,9,28,433,0,0,473,68,ITF,ITF2,14,Molise
2021-02-25,SAR,2899,1255,1644,1474,348,390,466,161,51,9,2294,605,ITG,ITG2,20,Sardegna
2021-01-06,SAR,1615,549,1066,1510,67,38,0,0,0,0,1615,0,ITG,ITG2,20,Sardegna
2021-02-19,UMB,743,293,450,282,12,2,14,433,0,0,526,217,ITI,ITI2,10,Umbria
2021-03-27,LAZ,25661,10236,15425,5589,103,6886,290,9204,134,3455,19396,6265,ITI,ITI4,12,Lazio
2021-03-19,VDA,319,84,235,8,1,70,21,9,1,209,284,35,ITC,ITC2,2,Valle d'Aosta / Vallée d'Aoste
2021-02-26,LOM,18338,7544,10794,3319,1660,274,1183,10574,1304,24,16490,1848,ITC,ITC4,3,Lombardia
2021-01-30,MAR,1908,669,1239,1566,0,342,0,0,0,0,29,1879,ITI,ITI3,11,Marche
2021-02-22,TOS,9817,4253,5564,3483,1390,889,316,22,1014,2703,9540,277,ITI,ITI1,9,Toscana
2021-02-14,EMR,1400,378,1022,859,338,145,39,19,0,0,1280,120,ITH,ITH5,8,Emilia-Romagna
2021-01-25,PAT,817,215,602,524,27,3,263,0,0,0,23,794,ITH,ITH2,4,Provincia Autonoma Trento
2021-04-13,PAB,2391,1130,1261,23,3,2327,1,29,2,6,2383,8,ITH,ITH1,4,Provincia Autonoma Bolzano / Bozen
2021-01-16,PAB,2820,1253,1567,435,93,269,77,1945,0,1,2820,0,ITH,ITH1,4,Provincia Autonoma Bolzano / Bozen
2021-02-18,BAS,1070,401,669,270,55,19,150,576,0,0,855,215,ITF,ITF5,17,Basilicata
2021-02-12,CAM,6528,2860,3668,1885,262,1111,208,3058,0,4,6342,186,ITF,ITF3,15,Campania
2021-01-22,CAM,1523,775,748,970,120,224,209,0,0,0,673,850,ITF,ITF3,15,Campania
2021-02-28,EMR,6822,2527,4295,1775,223,235,53,4228,4,304,4977,1845,ITH,ITH5,8,Emilia-Romagna
2021-03-26,UMB,4564,1682,2882,570,152,479,91,2482,52,738,4391,173,ITI,ITI2,10,Umbria
2021-03-26,EMR,23338,9869,13469,1416,326,9319,207,9300,142,2628,16927,6411,ITH,ITH5,8,Emilia-Romagna
2021-04-11,FVG,3427,1516,1911,235,94,1841,0,1222,7,28,2521,906,ITH,ITH4,6,Friuli-Venezia Giulia
2021-02-05,LIG,2673,986,1687,1743,357,75,494,0,0,4,304,2369,ITC,ITC3,7,Liguria
2021-02-08,PAT,1150,318,832,550,53,6,237,303,0,1,342,808,ITH,ITH2,4,Provincia Autonoma Trento
2021-03-26,LOM,40673,15424,25249,2650,1484,4299,785,22589,208,8658,27959,12714,ITC,ITC4,3,Lombardia
2021-02-09,EMR,4150,1245,2905,2218,226,242,1198,266,0,0,2305,1845,ITH,ITH5,8,Emilia-Romagna
2021-03-30,SIC,14567,6757,7810,715,32,8089,371,4992,113,255,9739,4828,ITG,ITG1,19,Sicilia
2021-04-17,PIE,29402,13720,15682,689,247,23573,48,4785,4,56,26191,3211,ITC,ITC1,1,Piemonte
2021-02-16,ABR,1978,869,1109,841,20,493,139,410,75,0,1966,12,ITF,ITF1,13,Abruzzo
2021-01-20,SIC,808,410,398,422,51,143,192,0,0,0,573,235,ITG,ITG1,19,Sicilia
2021-02-03,LIG,2315,791,1524,1626,212,60,416,0,0,1,55,2260,ITC,ITC3,7,Liguria
2021-03-10,PIE,13577,5123,8454,1666,732,645,280,8012,2,2240,11283,2294,ITC,ITC1,1,Piemonte
2021-03-18,FVG,3362,1420,1942,60,22,282,130,2864,0,4,1680,1682,ITH,ITH4,6,Friuli-Venezia Giulia
2021-03-05,FVG,3741,1481,2260,1050,652,42,70,1735,46,146,2668,1073,ITH,ITH4,6,Friuli-Venezia Giulia
2021-02-23,CAL,1549,728,821,437,33,348,206,522,2,1,1434,115,ITF,ITF6,18,Calabria
2021-04-15,TOS,23368,9792,13576,356,235,3378,174,19210,10,5,15234,8134,ITI,ITI1,9,Toscana
2021-02-07,PAB,2361,1057,1304,102,75,379,68,1737,0,0,14,2347,ITH,ITH1,4,Provincia Autonoma Bolzano / Bozen
2021-02-25,LIG,3439,1348,2091,550,91,125,88,2582,2,1,3310,129,ITC,ITC3,7,Liguria
2021-03-12,SAR,5755,2408,3347,1048,482,768,456,2571,271,159,4447,1308,ITG,ITG2,20,Sardegna
2021-01-16,VEN,4607,1542,3065,3194,274,482,657,0,0,0,4607,0,ITH,ITH3,5,Veneto
2021-01-28,VDA,290,123,167,202,34,46,6,2,0,0,56,234,ITC,ITC2,2,Valle d'Aosta / Vallée d'Aoste
2020-12-31,MAR,383,178,205,370,0,13,0,0,0,0,383,0,ITI,ITI3,11,Marche
2021-04-14,CAL,8002,3870,4132,172,5,6062,128,1424,36,175,6536,1466,ITF,ITF6,18,Calabria
2021-02-07,EMR,4787,1535,3252,3686,384,260,444,10,0,3,1728,3059,ITH,ITH5,8,Emilia-Romagna
2021-01-23,MAR,557,190,367,440,14,40,63,0,0,0,123,434,ITI,ITI3,11,Marche
2021-01-26,LAZ,7650,2929,4721,6592,213,67,631,147,0,0,419,7231,ITI,ITI4,12,Lazio
2021-01-02,FVG,1217,471,746,1150,0,67,0,0,0,0,1217,0,ITH,ITH4,6,Friuli-Venezia Giulia
2021-01-14,PUG,4063,1586,2477,3180,368,14,499,0,0,2,4063,0,ITF,ITF4,16,Puglia
2021-03-12,MOL,1458,637,821,42,31,47,0,718,115,505,1422,36,ITF,ITF2,14,Molise
2021-02-10,BAS,547,237,310,176,95,58,127,90,0,1,495,52,ITF,ITF5,17,Basilicata
2021-02-18,LIG,2761,1126,1635,958,119,329,349,1004,0,2,2431,330,ITC,ITC3,7,Liguria
2021-02-21,LOM,5022,1854,3168,1761,807,152,32,2227,40,3,5002,20,ITC,ITC4,3,Lombardia
2020-12-30,LOM,114,42,72,106,7,1,0,0,0,0,114,0,ITC,ITC4,3,Lombardia
2021-04-19,PIE,17128,8244,8884,232,123,12484,114,4149,1,25,13397,3731,ITC,ITC1,1,Piemonte
2021-02-13,LAZ,6354,2472,3882,2123,42,216,280,3693,0,0,6187,167,ITI,ITI4,12,Lazio
2021-03-28,LOM,20214,7693,12521,2014,838,2186,106,11167,30,3873,14146,6068,ITC,ITC4,3,Lombardia
2021-03-18,TOS,9932,3966,5966,437,544,932,280,7729,7,3,5982,3950,ITI,ITI1,9,Toscana
2021-04-13,BAS,2131,1059,1072,147,1,1092,0,817,1,73,1303,828,ITF,ITF5,17,Basilicata
2021-01-14,FVG,2588,789,1799,1608,14,536,430,0,0,0,2588,0,ITH,ITH4,6,Friuli-Venezia Giulia
2021-02-13,TOS,7784,2360,5424,3667,574,3193,163,0,186,1,7557,227,ITI,ITI1,9,Toscana
2021-02-11,CAM,6278,2704,3574,1861,279,1646,129,2363,0,0,6212,66,ITF,ITF3,15,Campania
2021-03-18,LAZ,14180,6059,8121,1767,90,2638,330,9340,9,6,7805,6375,ITI,ITI4,12,Lazio
2021-02-19,LIG,3096,1279,1817,989,124,469,97,1414,0,3,2920,176,ITC,ITC3,7,Liguria
2021-04-06,ABR,7687,3582,4105,433,7,4775,44,2340,34,54,5367,2320,ITF,ITF1,13,Abruzzo
2021-02-01,PAB,1449,439,1010,772,313,66,296,0,1,1,12,1437,ITH,ITH1,4,Provincia Autonoma Bolzano / Bozen
2021-03-22,ABR,4400,1959,2441,385,8,801,50,2578,136,442,2430,1970,ITF,ITF1,13,Abruzzo
2021-03-28,EMR,12561,5594,6967,277,75,6844,47,4808,184,326,9073,3488,ITH,ITH5,8,Emilia-Romagna
2021-03-04,PAT,2351,790,1561,161,24,51,23,1726,19,347,1572,779,ITH,ITH2,4,Provincia Autonoma Trento
2021-02-16,MAR,1292,475,817,737,8,455,92,0,0,0,1262,30,ITI,ITI3,11,Marche
2021-03-20,EMR,16027,6799,9228,702,328,4256,86,9291,533,831,9093,6934,ITH,ITH5,8,Emilia-Romagna
2021-02-10,SIC,4433,1819,2614,1975,221,1496,741,0,0,0,4008,425,ITG,ITG1,19,Sicilia
2021-02-25,TOS,10616,4302,6314,1078,421,1281,259,3213,1165,3199,9622,994,ITI,ITI1,9,Toscana
2021-04-05,PAB,301,144,157,5,3,218,0,70,4,1,23,278,ITH,ITH1,4,Provincia Autonoma Bolzano / Bozen
2021-03-27,BAS,2024,747,1277,17,0,99,0,1530,0,378,1710,314,ITF,ITF5,17,Basilicata
2021-02-24,VDA,183,82,101,30,7,7,13,66,53,7,164,19,ITC,ITC2,2,Valle d'Aosta / Vallée d'Aoste
2021-04-06,EMR,24569,11092,13477,637,114,12650,142,10567,49,410,19840,4729,ITH,ITH5,8,Emilia-Romagna
2021-03-22,MAR,5661,2378,3283,408,8,448,69,4182,113,433,2532,3129,ITI,ITI3,11,Marche
2021-04-05,TOS,15279,6824,8455,27,41,15103,0,71,2,35,14541,738,ITI,ITI1,9,Toscana
2021-01-24,PAT,547,276,271,535,12,0,0,0,0,0,224,323,ITH,ITH2,4,Provincia Autonoma Trento
2021-03-21,PAT,129,69,60,34,1,76,0,0,0,18,129,0,ITH,ITH2,4,Provincia Autonoma Trento
2021-03-15,SAR,2685,1216,1469,458,172,477,86,324,149,1019,2312,373,ITG,ITG2,20,Sardegna
2021-01-29,VDA,316,138,178,259,32,9,16,0,0,0,2,314,ITC,ITC2,2,Valle d'Aosta / Vallée d'Aoste
2021-04-14,LAZ,28431,12985,15446,3307,76,16716,148,8096,9,79,18456,9975,ITI,ITI4,12,Lazio
2021-02-09,SAR,2286,837,1449,1308,408,71,497,1,0,1,1290,996,ITG,ITG2,20,Sardegna
2021-03-05,CAL,6171,3565,2606,696,33,1557,710,1856,1314,5,5595,576,ITF,ITF6,18,Calabria
2021-01-31,EMR,7695,2761,4934,6174,806,452,263,0,0,0,242,7453,ITH,ITH5,8,Emilia-Romagna
2021-04-14,TOS,19648,8106,11542,397,333,2582,92,16233,10,1,14670,4978,ITI,ITI1,9,Toscana
2021-02-16,PIE,3965,1754,2211,1821,778,816,548,0,1,1,3207,758,ITC,ITC1,1,Piemonte
2021-04-18,LOM,35832,16008,19824,262,43,29810,58,5452,66,141,30648,5184,ITC,ITC4,3,Lombardia
2021-02-02,SIC,5541,2623,2918,3156,221,1735,429,0,0,0,633,4908,ITG,ITG1,19,Sicilia
2021-04-06,BAS,1397,478,919,205,0,234,1,343,26,588,1201,196,ITF,ITF5,17,Basilicata
2021-03-29,MAR,5895,2586,3309,228,5,1161,35,4240,11,215,3443,2452,ITI,ITI3,11,Marche
2021-03-08,TOS,6346,2610,3736,4063,746,990,191,66,282,8,1527,4819,ITI,ITI1,9,Toscana
2021-01-11,EMR,9330,3269,6061,6578,641,844,1267,0,0,0,9330,0,ITH,ITH5,8,Emilia-Romagna
2021-03-15,VDA,361,122,239,20,4,41,10,215,6,65,159,202,ITC,ITC2,2,Valle d'Aosta / Vallée d'Aoste
2021-01-25,EMR,6418,2129,4289,5237,124,379,678,0,0,0,202,6216,ITH,ITH5,8,Emilia-Romagna
2021-02-08,CAM,5112,2449,2663,1387,320,1801,226,1378,0,0,4310,802,ITF,ITF3,15,Campania
2021-01-16,PIE,7771,2630,5141,4802,1518,79,1372,0,0,0,7771,0,ITC,ITC1,1,Piemonte
2021-03-16,LOM,25437,10106,15331,3313,1353,1149,1433,18096,17,76,16401,9036,ITC,ITC4,3,Lombardia
2021-02-07,BAS,373,159,214,259,25,49,40,0,0,0,49,324,ITF,ITF5,17,Basilicata
2021-04-14,PUG,30527,14403,16124,618,59,24986,38,4701,43,82,27305,3222,ITF,ITF4,16,Puglia
2021-03-29,VDA,489,232,257,6,1,258,18,205,1,0,450,39,ITC,ITC2,2,Valle d'Aosta / Vallée d'Aoste
2021-02-15,MAR,973,413,560,544,60,368,1,0,0,0,960,13,ITI,ITI3,11,Marche
2021-02-05,UMB,780,234,546,645,51,0,84,0,0,0,18,762,ITI,ITI2,10,Umbria
2021-03-18,VEN,12582,5128,7454,1472,230,2012,495,7505,13,855,7359,5223,ITH,ITH3,5,Veneto
2021-02-11,LIG,1961,761,1200,1240,126,133,456,0,0,6,1091,870,ITC,ITC3,7,Liguria
2021-03-11,SAR,6034,2725,3309,1011,419,665,417,2950,470,102,4834,1200,ITG,ITG2,20,Sardegna
2021-01-16,CAM,3369,1675,1694,1355,230,1411,373,0,0,0,3369,0,ITF,ITF3,15,Campania
2021-01-08,FVG,2322,747,1575,1680,5,241,396,0,0,0,2322,0,ITH,ITH4,6,Friuli-Venezia Giulia
2021-02-03,TOS,4221,1452,2769,3475,239,1,505,1,0,0,241,3980,ITI,ITI1,9,Toscana
2021-02-26,PAB,1393,496,897,62,32,112,2,852,0,333,1363,30,ITH,ITH1,4,Provincia Autonoma Bolzano / Bozen
2021-03-23,MOL,1642,694,948,76,2,453,6,572,79,454,1435,207,ITF,ITF2,14,Molise
2021-03-06,PAB,3967,2079,1888,479,161,713,7,1969,257,381,3756,211,ITH,ITH1,4,Provincia Autonoma Bolzano / Bozen
2021-01-22,PAB,243,139,104,131,8,15,85,3,0,1,124,119,ITH,ITH1,4,Provincia Autonoma Bolzano / Bozen
2021-03-09,MAR,5532,2375,3157,754,8,463,36,2588,613,1070,4643,889,ITI,ITI3,11,Marche
2021-01-01,LIG,144,55,89,139,4,1,0,0,0,0,144,0,ITC,ITC3,7,Liguria
2021-03-13,LIG,3563,1514,2049,331,82,647,71,1522,120,790,2710,853,ITC,ITC3,7,Liguria
2021-02-07,ABR,777,307,470,646,6,124,1,0,0,0,201,576,ITF,ITF1,13,Abruzzo
2021-03-13,PAB,2885,1459,1426,168,53,1264,1,1290,89,20,2784,101,ITH,ITH1,4,Provincia Autonoma Bolzano / Bozen
2021-04-16,TOS,27996,12493,15503,519,367,12805,73,14210,20,2,21444,6552,ITI,ITI1,9,Toscana
2020-12-27,MOL,50,20,30,29,4,0,17,0,0,0,50,0,ITF,ITF2,14,Molise
2021-02-03,PIE,10197,3303,6894,6641,2041,269,1246,0,0,0,611,9586,ITC,ITC1,1,Piemonte
2021-02-03,UMB,725,174,551,560,34,0,131,0,0,0,67,658,ITI,ITI2,10,Umbria
2021-03-07,CAL,3131,1561,1570,105,0,655,348,1674,347,2,3042,89,ITF,ITF6,18,Calabria
2021-03-03,PAT,1653,621,1032,74,11,20,59,1267,19,203,1136,517,ITH,ITH2,4,Provincia Autonoma Trento
2021-04-11,EMR,15058,6836,8222,405,92,7627,104,6720,51,59,12039,3019,ITH,ITH5,8,Emilia-Romagna
2021-01-19,PAB,853,371,482,174,55,45,0,579,0,0,723,130,ITH,ITH1,4,Provincia Autonoma Bolzano / Bozen
2021-01-13,PAT,421,123,298,392,6,0,23,0,0,0,421,0,ITH,ITH2,4,Provincia Autonoma Trento
2021-03-18,SAR,7249,3065,4184,1078,241,1344,354,4157,12,63,5646,1603,ITG,ITG2,20,Sardegna
2021-02-18,FVG,3212,1489,1723,229,122,16,331,1502,34,978,2806,406,ITH,ITH4,6,Friuli-Venezia Giulia
2021-02-19,FVG,3254,1290,1964,568,309,14,313,1589,35,426,2825,429,ITH,ITH4,6,Friuli-Venezia Giulia
2021-01-18,LIG,2133,744,1389,1251,186,248,438,0,0,10,1976,157,ITC,ITC3,7,Liguria
2021-04-01,CAM,24304,11665,12639,416,50,14919,83,7005,206,1625,20174,4130,ITF,ITF3,15,Campania
2021-02-22,LIG,3328,1462,1866,712,100,112,235,2167,0,2,3190,138,ITC,ITC3,7,Liguria
2021-02-23,VEN,7364,3243,4121,1020,64,442,245,5343,67,183,7104,260,ITH,ITH3,5,Veneto
2021-03-16,LIG,6067,2718,3349,934,109,430,323,4262,3,6,2350,3717,ITC,ITC3,7,Liguria
2021-02-21,ABR,1221,551,670,2,0,4,3,1210,2,0,1220,1,ITF,ITF1,13,Abruzzo
2021-04-01,PIE,19205,7988,11217,665,288,3024,288,13843,183,914,11097,8108,ITC,ITC1,1,Piemonte
2021-01-07,UMB,1291,383,908,884,1,2,404,0,0,0,1291,0,ITI,ITI2,10,Umbria
2021-01-21,EMR,2154,726,1428,1285,97,119,653,0,0,0,809,1345,ITH,ITH5,8,Emilia-Romagna
2021-01-21,VDA,33,12,21,0,0,0,33,0,0,0,33,0,ITC,ITC2,2,Valle d'Aosta / Vallée d'Aoste
2021-02-12,PIE,6885,2212,4673,3527,1511,138,1707,0,0,2,3928,2957,ITC,ITC1,1,Piemonte
2021-02-26,VEN,8274,3262,5012,1781,205,825,742,4378,28,315,7022,1252,ITH,ITH3,5,Veneto
2021-01-21,LOM,5333,1567,3766,3017,1209,78,1025,4,0,0,4644,689,ITC,ITC4,3,Lombardia
2021-03-11,UMB,3539,1681,1858,144,604,175,239,2018,201,158,2533,1006,ITI,ITI2,10,Umbria
2021-02-05,SAR,1897,749,1148,1214,420,95,164,1,3,0,433,1464,ITG,ITG2,20,Sardegna
2021-01-17,BAS,328,133,195,233,11,30,54,0,0,0,327,1,ITF,ITF5,17,Basilicata
2021-01-10,SIC,3618,1615,2003,2126,125,903,464,0,0,0,3618,0,ITG,ITG1,19,Sicilia
2021-03-19,BAS,2284,988,1296,58,75,37,0,1950,22,142,261,2023,ITF,ITF5,17,Basilicata
2021-02-16,VDA,325,53,272,10,0,55,14,6,4,236,320,5,ITC,ITC2,2,Valle d'Aosta / Vallée d'Aoste
2021-03-07,PAT,22,6,16,0,0,0,0,0,0,22,22,0,ITH,ITH2,4,Provincia Autonoma Trento
2021-01-15,UMB,696,213,483,588,44,0,64,0,0,0,696,0,ITI,ITI2,10,Umbria
2021-03-28,LAZ,18786,7525,11261,1062,17,6545,77,8373,106,2606,13489,5297,ITI,ITI4,12,Lazio
2021-03-04,CAL,5389,3111,2278,646,105,1312,731,1540,1053,2,4593,796,ITF,ITF6,18,Calabria
2021-01-08,PAT,1449,313,1136,775,128,16,530,0,0,0,1449,0,ITH,ITH2,4,Provincia Autonoma Trento
2021-02-22,FVG,2493,1196,1297,431,312,15,115,1369,246,5,2075,418,ITH,ITH4,6,Friuli-Venezia Giulia
2021-01-31,CAL,1108,554,554,765,1,284,58,0,0,0,155,953,ITF,ITF6,18,Calabria
2021-01-04,ABR,1401,575,826,1396,0,5,0,0,0,0,1401,0,ITF,ITF1,13,Abruzzo
2021-03-11,ABR,5430,2191,3239,1328,39,519,241,1539,199,1565,4291,1139,ITF,ITF1,13,Abruzzo
2021-03-21,EMR,11901,5260,6641,566,320,3753,111,6094,470,587,7297,4604,ITH,ITH5,8,Emilia-Romagna
2021-04-18,LIG,2425,1078,1347,216,33,1625,44,506,0,1,1957,468,ITC,ITC3,7,Liguria
2021-02-20,CAM,8564,3079,5485,1023,60,788,145,4582,0,1966,8261,303,ITF,ITF3,15,Campania
2021-01-13,EMR,9068,2939,6129,6010,435,878,1744,0,0,1,9068,0,ITH,ITH5,8,Emilia-Romagna
2021-02-15,SIC,3951,1862,2089,1700,108,1237,563,10,307,26,3382,569,ITG,ITG1,19,Sicilia
2021-01-18,PUG,1845,770,1075,1182,210,6,445,1,1,0,1496,349,ITF,ITF4,16,Puglia
2021-01-28,LOM,12163,3686,8477,9178,1784,200,971,28,1,1,776,11387,ITC,ITC4,3,Lombardia
2021-01-06,PUG,3943,1664,2279,3313,218,39,373,0,0,0,3943,0,ITF,ITF4,16,Puglia
2021-04-12,SAR,6754,3063,3691,87,49,4431,44,2104,28,11,5182,1572,ITG,ITG2,20,Sardegna
2021-01-09,LAZ,6293,2560,3733,5115,229,329,620,0,0,0,6293,0,ITI,ITI4,12,Lazio
2021-03-20,TOS,6489,2882,3607,914,552,4771,165,29,24,34,5354,1135,ITI,ITI1,9,Toscana
2021-03-05,PAB,1802,613,1189,337,95,292,59,770,9,240,1360,442,ITH,ITH1,4,Provincia Autonoma Bolzano / Bozen
2021-03-05,SAR,5030,2443,2587,1692,775,655,669,570,659,10,2678,2352,ITG,ITG2,20,Sardegna
2021-04-11,PAT,2332,1131,1201,45,56,2022,8,21,5,175,2241,91,ITH,ITH2,4,Provincia Autonoma Trento
2021-03-28,CAL,2535,1172,1363,127,20,1217,26,719,14,412,1405,1130,ITF,ITF6,18,Calabria
2021-04-01,SIC,14465,6695,7770,624,29,8094,490,5017,20,191,9739,4726,ITG,ITG1,19,Sicilia
2021-01-03,LOM,853,316,537,744,88,16,4,1,0,0,853,0,ITC,ITC4,3,Lombardia
2021-02-28,FVG,2669,989,1680,234,162,1,0,405,379,1488,2274,395,ITH,ITH4,6,Friuli-Venezia Giulia
2021-03-10,VDA,436,182,254,9,0,67,17,337,6,0,225,211,ITC,ITC2,2,Valle d'Aosta / Vallée d'Aoste
2021-01-03,VEN,5159,1563,3596,4601,59,248,249,0,0,2,5159,0,ITH,ITH3,5,Veneto
2021-01-04,LOM,6075,2097,3978,4993,710,188,173,11,0,0,6075,0,ITC,ITC4,3,Lombardia
2021-03-11,PIE,13692,5018,8674,2312,808,638,381,7367,2,2184,10602,3090,ITC,ITC1,1,Piemonte
2021-02-19,SIC,5163,2758,2405,1488,183,1181,602,74,1396,239,4592,571,ITG,ITG1,19,Sicilia
2021-02-17,TOS,8173,3168,5005,3464,1122,51,249,218,584,2485,7422,751,ITI,ITI1,9,Toscana
2021-02-25,FVG,3075,1607,1468,22,4,125,188,1557,436,743,3050,25,ITH,ITH4,6,Friuli-Venezia Giulia
2021-01-09,UMB,1719,492,1227,888,7,0,824,0,0,0,1719,0,ITI,ITI2,10,Umbria
2021-04-18,PAB,3110,1607,1503,28,8,2913,0,134,0,27,2100,1010,ITH,ITH1,4,Provincia Autonoma Bolzano / Bozen
2021-03-12,FVG,3936,1542,2394,177,62,116,26,2865,101,589,2556,1380,ITH,ITH4,6,Friuli-Venezia Giulia
2021-03-08,PIE,13921,5284,8637,2041,892,545,413,7402,0,2628,11208,2713,ITC,ITC1,1,Piemonte
2021-03-06,VEN,10525,4260,6265,3176,48,2497,1491,1969,16,1328,7325,3200,ITH,ITH3,5,Veneto
2021-01-20,LIG,1548,554,994,726,121,219,480,0,0,2,1536,12,ITC,ITC3,7,Liguria
2021-03-27,PIE,18343,7812,10531,1215,547,2613,110,11695,54,2109,9530,8813,ITC,ITC1,1,Piemonte
2021-03-01,SAR,2160,1054,1106,1135,233,212,141,104,334,1,1501,659,ITG,ITG2,20,Sardegna
2021-03-10,EMR,18653,7642,11011,1314,218,1119,125,9934,1414,4529,13017,5636,ITH,ITH5,8,Emilia-Romagna
2021-01-27,PAT,802,277,525,463,33,1,304,1,0,0,91,711,ITH,ITH2,4,Provincia Autonoma Trento
2021-01-27,CAL,1457,734,723,1226,2,206,23,0,0,0,396,1061,ITF,ITF6,18,Calabria
2021-04-03,LIG,5187,2388,2799,116,19,3634,3,1393,3,19,4245,942,ITC,ITC3,7,Liguria
2021-02-28,MOL,829,331,498,38,1,4,27,759,0,0,787,42,ITF,ITF2,14,Molise
2021-03-15,LAZ,19219,8309,10910,2308,123,3555,411,9590,706,2526,12489,6730,ITI,ITI4,12,Lazio
2021-04-19,VDA,426,177,249,5,0,183,2,236,0,0,219,207,ITC,ITC2,2,Valle d'Aosta / Vallée d'Aoste
2021-01-23,TOS,3949,1354,2595,2936,170,2,841,0,0,0,640,3309,ITI,ITI1,9,Toscana
2021-04-12,BAS,2249,1086,1163,227,1,1371,12,523,13,102,1675,574,ITF,ITF5,17,Basilicata
2021-02-18,MOL,319,74,245,296,8,15,0,0,0,0,306,13,ITF,ITF2,14,Molise
2021-02-01,FVG,2095,688,1407,1589,254,117,135,0,0,0,15,2080,ITH,ITH4,6,Friuli-Venezia Giulia
2021-02-23,BAS,1901,771,1130,159,24,25,35,1658,0,0,1763,138,ITF,ITF5,17,Basilicata
2021-02-22,VDA,316,94,222,62,7,32,39,103,6,67,213,103,ITC,ITC2,2,Valle d'Aosta / Vallée d'Aoste
2021-01-28,LAZ,7973,3006,4967,6811,374,133,514,141,0,0,477,7496,ITI,ITI4,12,Lazio
2021-01-22,VEN,1080,332,748,947,35,38,57,0,0,3,25,1055,ITH,ITH3,5,Veneto
2021-04-18,EMR,16786,8051,8735,263,135,14012,120,2222,8,26,12313,4473,ITH,ITH5,8,Emilia-Romagna
2021-01-24,MAR,892,342,550,773,0,119,0,0,0,0,17,875,ITI,ITI3,11,Marche
2021-03-10,LOM,33123,12693,20430,6884,2528,2607,2054,12043,1531,5476,25283,7840,ITC,ITC4,3,Lombardia
2021-03-31,CAL,8824,4006,4818,378,10,3174,629,2513,68,2052,4884,3940,ITF,ITF6,18,Calabria
2021-04-07,LAZ,24529,11124,13405,2922,78,13401,189,7745,101,93,17432,7097,ITI,ITI4,12,Lazio
2021-04-17,VEN,21738,8832,12906,795,25,10659,130,10039,4,86,14494,7244,ITH,ITH3,5,Veneto
2021-01-30,LAZ,6677,2745,3932,5298,265,326,651,137,0,0,476,6201,ITI,ITI4,12,Lazio
2021-03-22,TOS,4836,2398,2438,221,347,3430,380,9,135,314,4393,443,ITI,ITI1,9,Toscana
2021-02-26,BAS,2148,904,1244,88,93,12,1,1954,0,0,2069,79,ITF,ITF5,17,Basilicata
2021-02-13,FVG,567,179,388,337,230,0,0,0,0,0,561,6,ITH,ITH4,6,Friuli-Venezia Giulia
2021-03-01,PIE,12035,4839,7196,1157,544,742,281,6872,4,2435,11226,809,ITC,ITC1,1,Piemonte
2021-04-08,TOS,29217,12336,16881,268,253,5308,186,23181,16,5,22937,6280,ITI,ITI1,9,Toscana
2021-01-25,BAS,1020,427,593,828,80,111,1,0,0,0,74,946,ITF,ITF5,17,Basilicata
2021-01-29,PAT,1352,331,1021,724,74,12,542,0,0,0,55,1297,ITH,ITH2,4,Provincia Autonoma Trento
2021-03-18,PUG,9220,4160,5060,1744,416,226,195,6509,39,91,3125,6095,ITF,ITF4,16,Puglia
2021-04-15,PAT,3094,1406,1688,179,110,2335,16,451,0,3,2974,120,ITH,ITH2,4,Provincia Autonoma Trento
2021-03-21,ABR,2135,913,1222,9,0,47,1,1919,29,130,844,1291,ITF,ITF1,13,Abruzzo
2021-02-14,SIC,1057,402,655,433,58,330,236,0,0,0,917,140,ITG,ITG1,19,Sicilia
2021-04-03,PAB,831,364,467,9,6,14,0,799,3,0,22,809,ITH,ITH1,4,Provincia Autonoma Bolzano / Bozen
2021-03-06,EMR,20493,5861,14632,2714,282,726,41,5868,517,10345,17770,2723,ITH,ITH5,8,Emilia-Romagna
2021-01-29,PUG,6192,2659,3533,5516,343,41,288,1,0,3,437,5755,ITF,ITF4,16,Puglia
2021-01-22,SAR,83,47,36,45,38,0,0,0,0,0,55,28,ITG,ITG2,20,Sardegna
2021-03-18,PAT,2275,944,1331,63,0,565,2,1640,2,3,1202,1073,ITH,ITH2,4,Provincia Autonoma Trento
2021-03-30,TOS,16712,7401,9311,211,129,7920,250,7899,190,113,13151,3561,ITI,ITI1,9,Toscana
2021-02-08,FVG,2357,694,1663,1401,521,0,435,0,0,0,92,2265,ITH,ITH4,6,Friuli-Venezia Giulia
2021-01-10,MOL,270,72,198,82,19,0,169,0,0,0,270,0,ITF,ITF2,14,Molise
2021-02-13,PAT,536,333,203,373,4,1,0,158,0,0,171,365,ITH,ITH2,4,Provincia Autonoma Trento
2021-04-17,ABR,6642,3076,3566,347,8,4304,21,1881,19,62,4028,2614,ITF,ITF1,13,Abruzzo
2021-03-17,LOM,26105,10439,15666,2531,1318,720,1943,19506,44,43,15220,10885,ITC,ITC4,3,Lombardia
2021-03-08,PUG,14626,6064,8562,2138,555,497,218,6755,526,3937,12233,2393,ITF,ITF4,16,Puglia
2021-02-14,PIE,1476,498,978,796,332,49,285,0,0,14,876,600,ITC,ITC1,1,Piemonte
2021-03-07,LAZ,14059,5419,8640,1201,24,1207,148,7250,696,3533,10470,3589,ITI,ITI4,12,Lazio
2021-04-19,TOS,6615,3292,3323,463,185,5788,44,126,2,7,5849,766,ITI,ITI1,9,Toscana
2021-04-13,SAR,7418,3474,3944,216,40,5552,45,1451,99,15,5643,1775,ITG,ITG2,20,Sardegna
2021-04-13,EMR,23321,10930,12391,466,112,16478,186,5992,36,51,19113,4208,ITH,ITH5,8,Emilia-Romagna
2021-04-19,LAZ,23943,10901,13042,472,83,16588,100,6641,25,34,15283,8660,ITI,ITI4,12,Lazio
2021-01-09,PUG,4871,2245,2626,4318,245,57,246,4,0,1,4871,0,ITF,ITF4,16,Puglia
2021-02-05,MAR,2157,653,1504,1318,20,400,419,0,0,0,440,1717,ITI,ITI3,11,Marche
2021-03-08,FVG,4041,1574,2467,694,366,176,140,2190,39,436,1953,2088,ITH,ITH4,6,Friuli-Venezia Giulia
2021-02-17,CAM,7388,3210,4178,1013,197,870,38,4908,0,362,6328,1060,ITF,ITF3,15,Campania
2021-03-01,ABR,3490,1393,2097,698,30,264,174,1914,128,282,2725,765,ITF,ITF1,13,Abruzzo
2021-03-17,EMR,13679,5682,7997,361,117,1300,69,11812,1,19,5861,7818,ITH,ITH5,8,Emilia-Romagna
2021-01-13,LAZ,5572,2072,3500,4146,270,137,1009,10,0,0,5572,0,ITI,ITI4,12,Lazio
2021-04-18,CAL,5767,2757,3010,148,2,4233,101,1194,10,79,4888,879,ITF,ITF6,18,Calabria
2021-02-24,PIE,11405,4628,6777,1855,588,723,408,5676,0,2155,10899,506,ITC,ITC1,1,Piemonte
2021-02-02,EMR,9461,3039,6422,6237,730,762,1631,100,0,1,517,8944,ITH,ITH5,8,Emilia-Romagna
2021-01-09,CAM,10566,5024,5542,6759,1256,2282,269,0,0,0,10566,0,ITF,ITF3,15,Campania
2021-03-10,PAT,2398,925,1473,354,36,25,25,1421,221,316,1477,921,ITH,ITH2,4,Provincia Autonoma Trento
2021-01-21,PUG,2129,903,1226,1429,166,7,527,0,0,0,1270,859,ITF,ITF4,16,Puglia
2021-04-07,LIG,12981,5761,7220,426,143,7491,103,4142,105,571,10831,2150,ITC,ITC3,7,Liguria
2021-01-06,EMR,8262,2942,5320,6852,169,592,648,0,1,0,8262,0,ITH,ITH5,8,Emilia-Romagna
2021-01-11,LAZ,5525,2103,3422,4553,307,96,569,0,0,0,5525,0,ITI,ITI4,12,Lazio
2020-12-27,ABR,37,19,18,34,0,1,2,0,0,0,37,0,ITF,ITF1,13,Abruzzo
2021-02-15,TOS,8768,3374,5394,4536,922,1106,216,56,794,1138,7943,825,ITI,ITI1,9,Toscana
2021-03-14,EMR,8690,3742,4948,728,175,932,69,5498,362,926,4895,3795,ITH,ITH5,8,Emilia-Romagna
2021-01-22,PUG,1407,577,830,877,150,5,373,1,0,1,990,417,ITF,ITF4,16,Puglia
2021-03-19,TOS,10084,4436,5648,641,439,4017,303,4636,13,35,7255,2829,ITI,ITI1,9,Toscana
2021-01-28,LIG,2841,969,1872,2239,182,105,309,0,1,5,39,2802,ITC,ITC3,7,Liguria
2021-03-04,TOS,17512,6672,10840,2816,275,1397,274,8191,865,3694,14436,3076,ITI,ITI1,9,Toscana
2021-04-03,UMB,2081,708,1373,143,22,406,30,1257,7,216,1053,1028,ITI,ITI2,10,Umbria
2021-02-16,CAM,5435,2410,3025,983,272,836,169,3174,0,1,4664,771,ITF,ITF3,15,Campania
2021-03-11,SIC,15503,6546,8957,1611,127,5106,906,3936,493,3324,12929,2574,ITG,ITG1,19,Sicilia
2021-04-03,EMR,19897,8748,11149,374,73,10184,33,8742,65,426,16168,3729,ITH,ITH5,8,Emilia-Romagna
2021-03-31,PIE,19078,8090,10988,962,405,3504,311,13152,57,687,10387,8691,ITC,ITC1,1,Piemonte
2021-02-10,PUG,3603,1425,2178,2491,247,0,864,0,0,1,2122,1481,ITF,ITF4,16,Puglia
2021-01-25,CAM,5744,2926,2818,4743,644,301,56,0,0,0,164,5580,ITF,ITF3,15,Campania
2021-03-27,VDA,332,164,168,23,6,221,14,66,1,1,301,31,ITC,ITC2,2,Valle d'Aosta / Vallée d'Aoste
2021-02-17,LOM,11952,3743,8209,7632,2181,107,1945,39,38,10,10563,1389,ITC,ITC4,3,Lombardia
2021-02-25,EMR,9212,3491,5721,797,142,386,156,7636,0,95,8257,955,ITH,ITH5,8,Emilia-Romagna
2021-02-28,VEN,4136,1389,2747,1741,30,1343,15,992,0,15,3299,837,ITH,ITH3,5,Veneto
2021-02-27,CAM,13943,4471,9472,825,285,1280,82,3160,0,8311,12301,1642,ITF,ITF3,15,Campania
2021-01-26,VEN,6914,2089,4825,5347,221,364,976,0,1,5,154,6760,ITH,ITH3,5,Veneto
2021-02-28,CAL,2168,983,1185,113,8,144,190,1707,6,0,2017,151,ITF,ITF6,18,Calabria
2021-02-18,CAM,9079,3811,5268,1752,228,1033,88,5540,0,438,8371,708,ITF,ITF3,15,Campania
2021-02-04,VEN,7317,2015,5302,3465,455,992,2380,19,0,6,553,6764,ITH,ITH3,5,Veneto
2021-02-18,SIC,5497,3174,2323,1636,165,1080,814,9,1697,96,5065,432,ITG,ITG1,19,Sicilia
2021-04-09,TOS,24127,10383,13744,234,115,3794,208,19756,17,3,20795,3332,ITI,ITI1,9,Toscana
2021-02-24,MAR,3496,1518,1978,229,11,227,214,2811,3,1,3416,80,ITI,ITI3,11,Marche
2020-12-30,MAR,17,5,12,14,0,3,0,0,0,0,17,0,ITI,ITI3,11,Marche
2021-02-23,TOS,7720,3324,4396,1490,530,1041,204,510,1114,2831,7559,161,ITI,ITI1,9,Toscana
2021-03-02,VDA,339,166,173,17,1,101,39,111,65,5,336,3,ITC,ITC2,2,Valle d'Aosta / Vallée d'Aoste
2021-01-17,MAR,1598,682,916,964,14,574,46,0,0,0,1549,49,ITI,ITI3,11,Marche
2021-01-14,UMB,750,200,550,697,35,0,17,0,0,1,750,0,ITI,ITI2,10,Umbria
2021-02-18,CAL,1801,804,997,586,55,454,299,346,0,61,1578,223,ITF,ITF6,18,Calabria
2021-03-06,PUG,15787,5896,9891,2104,361,376,71,5360,480,7035,13819,1968,ITF,ITF4,16,Puglia
2021-02-13,CAL,1331,583,748,731,18,470,111,1,0,0,968,363,ITF,ITF6,18,Calabria
2021-01-25,CAL,1065,512,553,1022,0,43,0,0,0,0,156,909,ITF,ITF6,18,Calabria
2021-02-21,SIC,5178,2508,2670,379,30,622,174,3682,138,153,5070,108,ITG,ITG1,19,Sicilia
2021-01-19,LOM,8098,2348,5750,4045,1744,77,2166,65,1,0,7622,476,ITC,ITC4,3,Lombardia
2021-03-02,MAR,4966,1943,3023,589,24,251,242,3319,3,538,4400,566,ITI,ITI3,11,Marche
2021-01-05,LAZ,7370,2802,4568,6690,0,102,577,0,1,0,7370,0,ITI,ITI4,12,Lazio
2021-03-10,CAL,6445,3280,3165,743,42,2312,586,2021,677,64,5252,1193,ITF,ITF6,18,Calabria
2021-01-26,CAM,7340,3726,3614,5775,847,487,231,0,0,0,352,6988,ITF,ITF3,15,Campania
2021-03-19,LAZ,17026,7274,9752,2123,140,3763,389,9357,248,1006,10725,6301,ITI,ITI4,12,Lazio
2020-12-31,PAT,1624,449,1175,841,105,2,676,0,0,0,1624,0,ITH,ITH2,4,Provincia Autonoma Trento
2021-02-14,CAM,3924,1921,2003,626,84,736,15,2463,0,0,3890,34,ITF,ITF3,15,Campania
2021-03-21,PAB,768,285,483,165,17,16,1,566,0,3,14,754,ITH,ITH1,4,Provincia Autonoma Bolzano / Bozen
2021-04-15,CAL,7392,3624,3768,160,6,5847,146,1022,12,199,5788,1604,ITF,ITF6,18,Calabria
2021-01-20,VDA,23,8,15,0,0,0,6,17,0,0,23,0,ITC,ITC2,2,Valle d'Aosta / Vallée d'Aoste
2021-01-13,PAB,1691,557,1134,446,309,501,270,165,0,0,1691,0,ITH,ITH1,4,Provincia Autonoma Bolzano / Bozen
2021-03-08,SAR,4001,1785,2216,740,492,669,650,853,444,153,2782,1219,ITG,ITG2,20,Sardegna
2021-03-29,UMB,3798,1647,2151,247,36,600,58,2830,1,26,2318,1480,ITI,ITI2,10,Umbria
2020-12-28,LAZ,959,412,547,957,0,2,0,0,0,0,959,0,ITI,ITI4,12,Lazio
2021-01-18,SIC,1576,657,919,721,75,551,229,0,0,0,1432,144,ITG,ITG1,19,Sicilia
2021-01-08,PUG,5575,2335,3240,4852,358,30,328,0,4,3,5575,0,ITF,ITF4,16,Puglia
2021-04-03,SIC,15846,7536,8310,438,14,10043,202,4939,18,192,13003,2843,ITG,ITG1,19,Sicilia
2021-02-19,CAL,1461,652,809,544,21,320,195,380,1,0,1200,261,ITF,ITF6,18,Calabria
2021-03-01,PUG,15042,5839,9203,1971,508,398,83,6117,820,5145,13674,1368,ITF,ITF4,16,Puglia
2021-02-25,LOM,15174,6293,8881,2969,1291,330,1294,8064,1216,10,13628,1546,ITC,ITC4,3,Lombardia
2021-04-12,CAL,6694,3262,3432,219,11,4628,269,1434,29,104,5092,1602,ITF,ITF6,18,Calabria
2021-02-01,ABR,1632,573,1059,1384,34,213,1,0,0,0,271,1361,ITF,ITF1,13,Abruzzo
2021-02-15,PAT,533,187,346,145,21,7,27,322,0,11,419,114,ITH,ITH2,4,Provincia Autonoma Trento
2020-12-27,BAS,106,41,65,104,0,2,0,0,0,0,106,0,ITF,ITF5,17,Basilicata
2021-03-22,MOL,1146,439,707,106,3,283,2,255,39,458,903,243,ITF,ITF2,14,Molise
2021-02-20,MAR,4127,1708,2419,118,24,387,261,3334,3,0,4016,111,ITI,ITI3,11,Marche
2021-04-13,CAM,26589,12673,13916,226,47,21719,97,4191,65,244,21062,5527,ITF,ITF3,15,Campania
2021-03-01,PAT,1237,454,783,74,1,17,10,1037,3,95,942,295,ITH,ITH2,4,Provincia Autonoma Trento
2021-01-27,BAS,411,175,236,299,16,70,26,0,0,0,113,298,ITF,ITF5,17,Basilicata
2021-04-09,MAR,9618,4219,5399,270,5,6350,32,1613,27,1321,9416,202,ITI,ITI3,11,Marche
2021-02-24,TOS,10366,4464,5902,81,302,1267,301,4137,1331,2947,10169,197,ITI,ITI1,9,Toscana
2021-04-10,MOL,2555,1233,1322,10,0,2297,0,226,3,19,2404,151,ITF,ITF2,14,Molise
2021-02-07,LAZ,4774,1917,2857,3252,138,306,218,859,0,1,383,4391,ITI,ITI4,12,Lazio
2021-02-09,PAT,914,287,627,447,8,5,73,381,0,0,441,473,ITH,ITH2,4,Provincia Autonoma Trento
2021-03-10,VEN,18879,8585,10294,1484,70,3280,560,9048,288,4149,13196,5683,ITH,ITH3,5,Veneto
2020-12-27,LOM,717,413,304,615,46,41,14,1,0,0,717,0,ITC,ITC4,3,Lombardia
2021-03-29,PAT,2429,953,1476,93,26,1220,5,990,4,91,1695,734,ITH,ITH2,4,Provincia Autonoma Trento
2021-04-16,MAR,9996,4654,5342,319,11,8408,43,688,14,513,9462,534,ITI,ITI3,11,Marche
2021-03-30,MAR,7445,3056,4389,524,2,2020,244,4258,30,367,4607,2838,ITI,ITI3,11,Marche
2021-02-21,SAR,1589,710,879,67,25,10,59,1422,6,0,1559,30,ITG,ITG2,20,Sardegna
2021-01-09,PIE,6183,2185,3998,4488,1094,33,568,0,0,0,6183,0,ITC,ITC1,1,Piemonte
2021-01-17,TOS,2535,871,1664,2002,293,0,240,0,0,0,2022,513,ITI,ITI1,9,Toscana
2021-02-12,FVG,1200,428,772,674,392,3,128,2,0,1,1150,50,ITH,ITH4,6,Friuli-Venezia Giulia
2021-03-08,ABR,5128,1670,3458,1190,30,477,113,1019,104,2195,4153,975,ITF,ITF1,13,Abruzzo
2021-01-31,SAR,2121,750,1371,1544,128,448,0,1,0,0,48,2073,ITG,ITG2,20,Sardegna
2021-04-15,FVG,5279,2363,2916,186,54,3337,49,1649,0,4,4155,1124,ITH,ITH4,6,Friuli-Venezia Giulia
2021-02-15,PUG,3253,1268,1985,2249,522,19,453,1,6,3,2633,620,ITF,ITF4,16,Puglia
2021-01-09,PAT,190,40,150,146,13,0,31,0,0,0,190,0,ITH,ITH2,4,Provincia Autonoma Trento
2021-03-28,TOS,6202,2800,3402,37,20,5409,145,483,19,89,5948,254,ITI,ITI1,9,Toscana
2021-03-31,ABR,6655,2882,3773,446,5,2615,77,3255,12,245,4587,2068,ITF,ITF1,13,Abruzzo
2021-03-03,BAS,1740,813,927,191,252,161,99,590,203,244,1184,556,ITF,ITF5,17,Basilicata
2021-01-02,LIG,691,245,446,595,54,42,0,0,0,0,691,0,ITC,ITC3,7,Liguria
2020-12-28,SIC,207,124,83,205,0,2,0,0,0,0,207,0,ITG,ITG1,19,Sicilia
2021-01-11,SIC,5905,2591,3314,3923,196,1404,382,0,0,0,5905,0,ITG,ITG1,19,Sicilia
2021-03-24,SIC,21152,9897,11255,956,64,12177,550,5857,86,1462,15264,5888,ITG,ITG1,19,Sicilia
2021-03-19,PUG,7923,3638,4285,1759,251,178,69,5344,63,259,3384,4539,ITF,ITF4,16,Puglia
2021-01-02,PAB,91,48,43,69,1,21,0,0,0,0,91,0,ITH,ITH1,4,Provincia Autonoma Bolzano / Bozen
2021-01-13,MAR,2105,746,1359,1408,11,610,76,0,0,0,2105,0,ITI,ITI3,11,Marche
2021-04-17,PAT,2200,1118,1082,13,2,2108,0,77,0,0,2143,57,ITH,ITH2,4,Provincia Autonoma Trento
2021-04-04,BAS,543,215,328,9,0,40,0,406,0,88,130,413,ITF,ITF5,17,Basilicata
2021-01-31,VEN,4766,1561,3205,3713,154,511,377,5,2,4,393,4373,ITH,ITH3,5,Veneto
2021-03-07,VDA,64,30,34,16,3,16,0,26,2,1,11,53,ITC,ITC2,2,Valle d'Aosta / Vallée d'Aoste
2021-03-17,VEN,14596,5961,8635,1968,170,2671,300,8777,10,700,7831,6765,ITH,ITH3,5,Veneto
2021-01-22,PAT,1668,433,1235,904,121,9,631,0,0,3,329,1339,ITH,ITH2,4,Provincia Autonoma Trento
2021-01-09,CAL,1916,1036,880,1529,0,387,0,0,0,0,1916,0,ITF,ITF6,18,Calabria
2021-01-08,CAM,10456,4969,5487,6715,1147,2382,212,0,0,0,10456,0,ITF,ITF3,15,Campania
2021-02-16,PAT,663,244,419,73,2,12,3,563,0,10,658,5,ITH,ITH2,4,Provincia Autonoma Trento
2021-02-19,MOL,169,93,76,95,28,42,1,0,0,3,167,2,ITF,ITF2,14,Molise
2020-12-30,PAB,387,181,206,342,41,4,0,0,0,0,387,0,ITH,ITH1,4,Provincia Autonoma Bolzano / Bozen
2021-01-18,VDA,213,74,139,29,7,104,27,46,0,0,213,0,ITC,ITC2,2,Valle d'Aosta / Vallée d'Aoste
2021-01-28,MOL,613,217,396,430,9,19,154,0,0,1,17,596,ITF,ITF2,14,Molise
2021-03-10,ABR,4951,1640,3311,736,29,426,242,1519,127,1872,3994,957,ITF,ITF1,13,Abruzzo
2021-02-28,SAR,368,169,199,245,69,7,47,0,0,0,142,226,ITG,ITG2,20,Sardegna
2021-01-21,CAL,958,444,514,735,1,107,115,0,0,0,929,29,ITF,ITF6,18,Calabria
2021-04-14,VDA,933,424,509,16,3,524,0,389,0,1,711,222,ITC,ITC2,2,Valle d'Aosta / Vallée d'Aoste
2021-04-19,MAR,6302,2930,3372,183,1,5272,0,789,11,46,5069,1233,ITI,ITI3,11,Marche
2021-01-07,PIE,5386,1739,3647,4158,838,49,341,0,0,0,5386,0,ITC,ITC1,1,Piemonte
2021-03-14,CAL,2543,1018,1525,322,2,374,312,802,9,722,2143,400,ITF,ITF6,18,Calabria
2021-04-15,VDA,806,375,431,30,1,564,0,208,2,1,667,139,ITC,ITC2,2,Valle d'Aosta / Vallée d'Aoste
2021-02-09,VEN,5175,1876,3299,3099,313,548,1190,19,0,6,3444,1731,ITH,ITH3,5,Veneto
2021-01-11,PAB,1567,513,1054,585,282,371,175,154,0,0,1567,0,ITH,ITH1,4,Provincia Autonoma Bolzano / Bozen
2021-03-29,PUG,12674,5906,6768,1590,348,1330,236,7906,136,1128,5963,6711,ITF,ITF4,16,Puglia
2021-01-20,PIE,6535,2066,4469,3568,1141,13,1813,0,0,0,5818,717,ITC,ITC1,1,Piemonte
2021-02-12,CAL,1711,669,1042,815,42,718,136,0,0,0,943,768,ITF,ITF6,18,Calabria
2021-03-20,MAR,4146,1745,2401,181,8,110,111,3641,6,89,1054,3092,ITI,ITI3,11,Marche
2021-01-11,SAR,1183,505,678,656,139,387,0,1,0,0,1183,0,ITG,ITG2,20,Sardegna
2021-02-06,EMR,7540,2387,5153,5363,480,466,1181,50,0,0,2123,5417,ITH,ITH5,8,Emilia-Romagna
2021-03-16,MOL,614,230,384,13,3,188,11,395,4,0,267,347,ITF,ITF2,14,Molise
2021-01-25,SAR,588,212,376,553,29,6,0,0,0,0,22,566,ITG,ITG2,20,Sardegna
2021-03-14,CAM,8505,3721,4784,328,97,666,2,4544,850,2018,4367,4138,ITF,ITF3,15,Campania
2021-02-08,LAZ,9416,3923,5493,3789,428,493,918,3788,0,0,4492,4924,ITI,ITI4,12,Lazio
2021-01-02,BAS,949,380,569,855,39,52,0,0,0,3,949,0,ITF,ITF5,17,Basilicata
2021-03-27,SIC,15807,7461,8346,650,26,8418,350,5587,34,742,10887,4920,ITG,ITG1,19,Sicilia
2021-03-06,PAT,773,277,496,362,10,6,0,195,5,195,622,151,ITH,ITH2,4,Provincia Autonoma Trento
2021-02-03,LOM,25468,7874,17594,15586,5561,152,4018,142,8,1,1120,24348,ITC,ITC4,3,Lombardia
2021-03-11,VDA,192,72,120,2,0,14,7,166,1,2,64,128,ITC,ITC2,2,Valle d'Aosta / Vallée d'Aoste
2021-02-26,EMR,7806,2967,4839,1058,312,388,244,5492,0,312,6760,1046,ITH,ITH5,8,Emilia-Romagna
2021-04-09,SAR,11752,5195,6557,436,75,6390,39,4616,33,163,7640,4112,ITG,ITG2,20,Sardegna
2021-03-30,VEN,35647,15101,20546,775,118,16461,580,17170,72,471,30392,5255,ITH,ITH3,5,Veneto
2021-01-21,VEN,2290,719,1571,1986,48,112,141,0,0,3,21,2269,ITH,ITH3,5,Veneto
2021-01-05,BAS,945,409,536,861,38,46,0,0,0,0,945,0,ITF,ITF5,17,Basilicata
2021-02-05,MOL,593,269,324,460,22,48,63,0,0,0,55,538,ITF,ITF2,14,Molise
2021-01-20,BAS,84,22,62,0,0,84,0,0,0,0,84,0,ITF,ITF5,17,Basilicata
2021-03-09,BAS,1391,706,685,222,47,48,33,545,258,238,787,604,ITF,ITF5,17,Basilicata
2021-02-10,CAM,6904,3413,3491,1945,284,2419,98,2158,0,0,6728,176,ITF,ITF3,15,Campania
2020-12-31,PUG,1635,782,853,1549,33,6,44,0,0,3,1635,0,ITF,ITF4,16,Puglia
2021-02-03,VEN,5935,1661,4274,2854,428,898,1746,3,0,6,481,5454,ITH,ITH3,5,Veneto
2021-03-23,BAS,1192,490,702,48,0,30,0,817,20,277,1085,107,ITF,ITF5,17,Basilicata
2021-02-20,VDA,251,210,41,6,2,47,11,2,174,9,241,10,ITC,ITC2,2,Valle d'Aosta / Vallée d'Aoste
2021-01-05,PIE,5380,1602,3778,4367,683,45,285,0,0,0,5380,0,ITC,ITC1,1,Piemonte
2021-04-08,VDA,582,282,300,6,0,297,4,273,0,2,438,144,ITC,ITC2,2,Valle d'Aosta / Vallée d'Aoste
2021-01-30,VEN,8745,2671,6074,6288,308,890,1234,4,12,9,694,8051,ITH,ITH3,5,Veneto
2021-01-11,VDA,325,112,213,238,50,7,30,0,0,0,325,0,ITC,ITC2,2,Valle d'Aosta / Vallée d'Aoste
2021-03-29,LAZ,23661,10624,13037,2062,87,10837,143,9476,259,797,16766,6895,ITI,ITI4,12,Lazio
2021-01-20,ABR,447,156,291,147,1,95,204,0,0,0,445,2,ITF,ITF1,13,Abruzzo
2021-03-05,UMB,4591,1379,3212,604,296,93,7,689,348,2554,3935,656,ITI,ITI2,10,Umbria
2021-02-21,FVG,800,281,519,213,166,11,26,382,1,1,423,377,ITH,ITH4,6,Friuli-Venezia Giulia
2021-01-06,PAT,42,13,29,42,0,0,0,0,0,0,42,0,ITH,ITH2,4,Provincia Autonoma Trento
2021-02-12,SAR,2237,933,1304,986,660,89,501,1,0,0,2178,59,ITG,ITG2,20,Sardegna
2021-03-17,MOL,905,384,521,45,22,211,42,572,12,1,574,331,ITF,ITF2,14,Molise
2021-03-07,TOS,5648,2356,3292,3103,511,586,123,15,536,774,2106,3542,ITI,ITI1,9,Toscana
2021-02-10,LIG,2275,827,1448,1350,233,186,496,5,0,5,1014,1261,ITC,ITC3,7,Liguria
2021-02-09,PUG,3838,1568,2270,2532,661,8,622,9,0,6,2166,1672,ITF,ITF4,16,Puglia
2021-02-14,LOM,3578,1546,2032,2750,491,282,42,3,0,10,2944,634,ITC,ITC4,3,Lombardia
2021-02-27,LOM,13939,5864,8075,2090,1104,772,568,8266,1091,48,13294,645,ITC,ITC4,3,Lombardia
2021-02-02,UMB,942,274,668,713,16,1,212,0,0,0,32,910,ITI,ITI2,10,Umbria
2021-04-05,ABR,2696,1150,1546,136,1,1167,3,1368,5,16,1816,880,ITF,ITF1,13,Abruzzo
2021-04-02,PIE,20040,8254,11786,885,326,4156,389,13314,92,878,11640,8400,ITC,ITC1,1,Piemonte
2021-01-18,PAT,642,154,488,528,35,6,73,0,0,0,587,55,ITH,ITH2,4,Provincia Autonoma Trento
2021-04-16,EMR,27961,13172,14789,607,83,21487,83,5616,14,71,19439,8522,ITH,ITH5,8,Emilia-Romagna
2021-01-31,MOL,268,70,198,85,18,0,164,0,0,1,6,262,ITF,ITF2,14,Molise
2021-01-24,TOS,3349,1073,2276,2602,35,2,709,1,0,0,201,3148,ITI,ITI1,9,Toscana
2021-04-04,EMR,9867,4709,5158,188,87,4964,0,4520,51,57,7598,2269,ITH,ITH5,8,Emilia-Romagna
2021-01-15,LIG,2254,753,1501,1326,272,137,517,0,0,2,2254,0,ITC,ITC3,7,Liguria
2021-03-15,MAR,4513,2120,2393,300,4,469,8,3476,14,242,1423,3090,ITI,ITI3,11,Marche
2021-02-08,CAL,1847,733,1114,1214,158,354,121,0,0,0,661,1186,ITF,ITF6,18,Calabria
2021-01-29,PIE,5941,1886,4055,4199,1018,51,673,0,0,0,455,5486,ITC,ITC1,1,Piemonte
2021-04-18,CAM,27152,13258,13894,108,19,21369,7,5341,68,240,18258,8894,ITF,ITF3,15,Campania
2021-03-25,TOS,23451,10057,13394,225,269,6221,406,15402,218,710,15162,8289,ITI,ITI1,9,Toscana
2021-03-06,SAR,2638,1079,1559,1108,543,393,467,12,79,36,857,1781,ITG,ITG2,20,Sardegna
2021-02-24,PUG,10011,4689,5322,1923,417,272,117,6360,365,557,9422,589,ITF,ITF4,16,Puglia
2021-02-17,SAR,1406,576,830,689,292,85,313,0,27,0,1332,74,ITG,ITG2,20,Sardegna
2021-01-29,CAM,10052,4812,5240,6405,1052,2336,259,0,0,0,47,10005,ITF,ITF3,15,Campania
2021-01-06,UMB,843,323,520,840,0,3,0,0,0,0,843,0,ITI,ITI2,10,Umbria
2021-03-05,ABR,5262,1938,3324,561,10,447,108,2582,202,1352,4564,698,ITF,ITF1,13,Abruzzo
2021-03-27,PAT,1609,705,904,270,188,854,0,61,72,164,1357,252,ITH,ITH2,4,Provincia Autonoma Trento
2021-03-08,LOM,29627,11131,18496,6568,1979,2053,1160,11735,1575,4557,22559,7068,ITC,ITC4,3,Lombardia
2021-03-02,TOS,10583,3787,6796,3170,432,598,154,1847,870,3512,7139,3444,ITI,ITI1,9,Toscana
2021-03-16,EMR,12200,5002,7198,418,72,766,101,10711,9,123,4931,7269,ITH,ITH5,8,Emilia-Romagna
2021-04-01,MAR,7593,3186,4407,390,4,2261,38,4590,26,284,4167,3426,ITI,ITI3,11,Marche
2021-01-22,EMR,1828,477,1351,942,25,139,722,0,0,0,1088,740,ITH,ITH5,8,Emilia-Romagna
2021-02-09,MOL,359,170,189,161,83,5,110,0,0,0,197,162,ITF,ITF2,14,Molise
2021-02-16,SAR,700,289,411,376,135,77,112,0,0,0,673,27,ITG,ITG2,20,Sardegna
2021-03-01,PAB,917,220,697,18,2,157,5,0,0,735,917,0,ITH,ITH1,4,Provincia Autonoma Bolzano / Bozen
2021-02-16,PAB,529,205,324,10,1,6,0,512,0,0,529,0,ITH,ITH1,4,Provincia Autonoma Bolzano / Bozen
2021-01-04,MAR,1500,563,937,1290,36,163,11,0,0,0,1500,0,ITI,ITI3,11,Marche
2021-01-03,MAR,896,348,548,759,0,137,0,0,0,0,896,0,ITI,ITI3,11,Marche
2021-04-17,LOM,45830,20192,25638,511,110,34289,152,10371,77,320,35864,9966,ITC,ITC4,3,Lombardia
2021-03-10,UMB,3985,1908,2077,122,745,113,157,2564,209,75,2729,1256,ITI,ITI2,10,Umbria
2021-04-12,CAM,23306,10922,12384,149,57,19467,70,3263,83,217,20268,3038,ITF,ITF3,15,Campania
2021-03-16,SIC,10171,4464,5707,1663,105,1630,810,5677,68,218,4019,6152,ITG,ITG1,19,Sicilia
2021-03-21,BAS,1045,480,565,32,0,51,0,803,0,159,352,693,ITF,ITF5,17,Basilicata
2021-02-12,PAT,1010,340,670,335,54,13,55,553,0,0,589,421,ITH,ITH2,4,Provincia Autonoma Trento
2021-03-05,BAS,1849,855,994,298,123,104,72,689,254,309,1104,745,ITF,ITF5,17,Basilicata
2021-03-06,UMB,4265,1110,3155,422,178,71,26,1126,120,2322,4122,143,ITI,ITI2,10,Umbria
2021-03-04,VDA,291,139,152,56,13,44,2,160,14,2,42,249,ITC,ITC2,2,Valle d'Aosta / Vallée d'Aoste
2021-01-18,FVG,1962,607,1355,1360,4,488,110,0,0,0,1868,94,ITH,ITH4,6,Friuli-Venezia Giulia
2021-02-16,UMB,1307,655,652,34,4,7,0,1262,0,0,1298,9,ITI,ITI2,10,Umbria
2021-01-13,VDA,337,110,227,166,138,5,28,0,0,0,337,0,ITC,ITC2,2,Valle d'Aosta / Vallée d'Aoste
2021-03-20,CAL,6482,2982,3500,432,7,1583,398,3562,34,466,4094,2388,ITF,ITF6,18,Calabria
2021-03-20,PAT,868,399,469,154,97,471,0,77,0,69,667,201,ITH,ITH2,4,Provincia Autonoma Trento
2021-01-29,VEN,9007,2783,6224,6050,479,1034,1434,3,1,6,368,8639,ITH,ITH3,5,Veneto
2021-04-10,VDA,401,189,212,2,0,376,1,22,0,0,396,5,ITC,ITC2,2,Valle d'Aosta / Vallée d'Aoste
2021-03-18,ABR,3896,1651,2245,281,2,284,3,3297,22,7,2065,1831,ITF,ITF1,13,Abruzzo
2021-01-19,MAR,225,81,144,120,0,20,85,0,0,0,141,84,ITI,ITI3,11,Marche
2021-01-07,BAS,640,319,321,556,8,47,29,0,0,0,640,0,ITF,ITF5,17,Basilicata
2021-01-06,LIG,1660,616,1044,1230,41,209,113,64,0,3,1660,0,ITC,ITC3,7,Liguria
2021-01-10,LIG,648,262,386,369,84,19,176,0,0,0,648,0,ITC,ITC3,7,Liguria
2021-03-03,VEN,11984,4547,7437,3339,303,1166,1222,3376,236,2342,8490,3494,ITH,ITH3,5,Veneto
2021-02-13,PUG,3722,1453,2269,2883,507,12,291,4,18,7,3029,693,ITF,ITF4,16,Puglia
2021-03-11,MAR,6832,2930,3902,1094,11,911,38,3227,403,1148,5461,1371,ITI,ITI3,11,Marche
2021-02-24,CAL,1843,940,903,658,7,359,115,653,47,4,1368,475,ITF,ITF6,18,Calabria
2021-03-31,VEN,38052,15897,22155,1614,90,16131,807,18882,123,405,30607,7445,ITH,ITH3,5,Veneto
2021-01-22,CAL,656,274,382,298,4,244,110,0,0,0,654,2,ITF,ITF6,18,Calabria
2021-01-27,FVG,1272,425,847,851,1,356,64,0,0,0,450,822,ITH,ITH4,6,Friuli-Venezia Giulia
2021-02-05,VDA,294,102,192,159,45,37,0,53,0,0,101,193,ITC,ITC2,2,Valle d'Aosta / Vallée d'Aoste
2021-02-13,ABR,849,384,465,552,25,200,72,0,0,0,437,412,ITF,ITF1,13,Abruzzo
2021-01-14,TOS,3254,1179,2075,2459,475,0,320,0,0,0,3254,0,ITI,ITI1,9,Toscana
2021-03-13,MAR,5877,2708,3169,664,21,517,57,4248,133,237,1916,3961,ITI,ITI3,11,Marche
2021-03-10,SAR,6009,2917,3092,719,383,516,414,2985,657,335,5159,850,ITG,ITG2,20,Sardegna
2021-02-02,LIG,2668,1005,1663,1974,195,33,464,0,0,2,134,2534,ITC,ITC3,7,Liguria
2021-03-10,PAB,1261,524,737,659,9,261,0,134,80,118,1118,143,ITH,ITH1,4,Provincia Autonoma Bolzano / Bozen
2021-03-13,VDA,142,84,58,2,1,113,0,0,23,3,142,0,ITC,ITC2,2,Valle d'Aosta / Vallée d'Aoste
2021-01-02,SIC,4872,2533,2339,4311,0,561,0,0,0,0,4872,0,ITG,ITG1,19,Sicilia
2021-02-17,UMB,1618,748,870,363,3,11,0,1240,0,1,1267,351,ITI,ITI2,10,Umbria
2021-01-26,MOL,450,184,266,444,0,5,0,0,0,1,8,442,ITF,ITF2,14,Molise
2021-01-06,PAB,59,18,41,59,0,0,0,0,0,0,59,0,ITH,ITH1,4,Provincia Autonoma Bolzano / Bozen
2021-04-16,VDA,596,261,335,63,8,501,2,22,0,0,594,2,ITC,ITC2,2,Valle d'Aosta / Vallée d'Aoste
2021-01-30,SIC,7838,3569,4269,5451,253,1659,475,0,0,0,175,7663,ITG,ITG1,19,Sicilia
2021-03-13,ABR,4254,1460,2794,539,17,1009,137,1468,23,1061,3178,1076,ITF,ITF1,13,Abruzzo
2021-01-14,SIC,5250,2514,2736,3046,91,1854,259,0,0,0,5250,0,ITG,ITG1,19,Sicilia
2021-03-21,SIC,15224,7336,7888,489,10,9115,57,4503,92,958,11250,3974,ITG,ITG1,19,Sicilia
2021-01-17,PIE,3517,1168,2349,2082,588,7,840,0,0,0,2870,647,ITC,ITC1,1,Piemonte
2021-04-01,LOM,42314,16974,25340,2709,1679,6003,1249,24833,103,5738,26537,15777,ITC,ITC4,3,Lombardia
2021-03-10,LIG,5756,2782,2974,823,94,700,95,3627,416,1,3852,1904,ITC,ITC3,7,Liguria
2021-01-05,LOM,7815,2563,5252,6270,1138,227,173,7,0,0,7815,0,ITC,ITC4,3,Lombardia
2021-02-02,FVG,2467,806,1661,1658,393,0,416,0,0,0,217,2250,ITH,ITH4,6,Friuli-Venezia Giulia
2021-01-27,VEN,7140,2065,5075,5211,211,828,879,2,0,9,245,6895,ITH,ITH3,5,Veneto
2021-03-01,CAL,2689,1534,1155,399,6,416,257,971,637,3,2239,450,ITF,ITF6,18,Calabria
2021-04-14,MAR,10276,4594,5682,418,2,7893,33,900,17,1013,9902,374,ITI,ITI3,11,Marche
2021-04-02,VDA,868,343,525,61,5,413,12,191,9,177,645,223,ITC,ITC2,2,Valle d'Aosta / Vallée d'Aoste
2021-04-18,PAT,1851,843,1008,10,52,1760,4,22,0,3,1843,8,ITH,ITH2,4,Provincia Autonoma Trento
2021-02-02,SAR,1482,655,827,988,187,307,0,0,0,0,241,1241,ITG,ITG2,20,Sardegna
2021-02-22,LOM,11705,4723,6982,4175,1402,144,961,4030,965,28,11395,310,ITC,ITC4,3,Lombardia
2021-03-27,CAM,21253,10021,11232,356,35,11580,63,7117,146,1956,17390,3863,ITF,ITF3,15,Campania
2021-01-20,SAR,210,77,133,154,56,0,0,0,0,0,208,2,ITG,ITG2,20,Sardegna
2021-04-08,PIE,24968,10842,14126,1055,448,11516,271,11204,62,412,20266,4702,ITC,ITC1,1,Piemonte
2021-03-23,SAR,6085,2587,3498,1108,209,976,260,2302,90,1140,5008,1077,ITG,ITG2,20,Sardegna
2021-01-05,VEN,7332,2184,5148,5419,304,481,1122,0,1,5,7332,0,ITH,ITH3,5,Veneto
2021-02-14,LAZ,5617,2286,3331,1645,20,355,127,3470,0,0,5291,326,ITI,ITI4,12,Lazio
2021-01-26,PIE,6329,1878,4451,4726,831,44,728,0,0,0,735,5594,ITC,ITC1,1,Piemonte
2021-04-18,PUG,20734,9878,10856,70,3,19375,2,1273,3,8,19676,1058,ITF,ITF4,16,Puglia
2021-03-22,CAM,12745,5922,6823,309,755,5170,71,3500,469,2471,10707,2038,ITF,ITF3,15,Campania
2021-01-20,VEN,1038,368,670,695,58,69,213,2,0,1,386,652,ITH,ITH3,5,Veneto
2021-03-06,FVG,3491,1194,2297,182,148,111,1,1565,20,1464,3165,326,ITH,ITH4,6,Friuli-Venezia Giulia
2021-01-10,TOS,3001,1104,1897,2432,134,4,431,0,0,0,3001,0,ITI,ITI1,9,Toscana
2021-04-09,LIG,11949,5367,6582,525,174,7071,79,3493,27,580,10342,1607,ITC,ITC3,7,Liguria
2021-03-03,ABR,4629,1883,2746,1222,6,577,36,1587,346,855,3723,906,ITF,ITF1,13,Abruzzo
2021-04-17,BAS,3453,1654,1799,53,5,2152,0,1232,1,10,2191,1262,ITF,ITF5,17,Basilicata
2021-03-15,MOL,832,338,494,137,6,149,66,116,61,297,587,245,ITF,ITF2,14,Molise
2021-04-09,PAB,2922,1289,1633,337,109,2079,102,277,4,14,2193,729,ITH,ITH1,4,Provincia Autonoma Bolzano / Bozen
2021-02-04,LOM,27295,7997,19298,15674,5739,151,5530,194,7,0,1962,25333,ITC,ITC4,3,Lombardia
2021-01-26,EMR,8330,3000,5330,6605,228,465,1032,0,0,0,215,8115,ITH,ITH5,8,Emilia-Romagna
2021-01-11,LIG,2653,990,1663,1991,143,202,316,0,0,1,2653,0,ITC,ITC3,7,Liguria
2021-03-01,UMB,1503,774,729,110,10,15,0,1249,118,1,1389,114,ITI,ITI2,10,Umbria
2021-02-09,CAL,2147,904,1243,1422,220,274,231,0,0,0,948,1199,ITF,ITF6,18,Calabria
2021-01-09,VEN,7931,2538,5393,5201,337,800,1573,3,11,6,7931,0,ITH,ITH3,5,Veneto
2021-02-24,PAT,1318,523,795,236,5,7,29,974,1,66,922,396,ITH,ITH2,4,Provincia Autonoma Trento
2021-02-06,MAR,2460,900,1560,1402,40,603,415,0,0,0,523,1937,ITI,ITI3,11,Marche
2021-04-13,VEN,13742,6209,7533,710,93,7447,287,5137,2,66,8304,5438,ITH,ITH3,5,Veneto
2021-04-11,CAM,17521,8606,8915,116,10,15297,2,1832,61,203,15443,2078,ITF,ITF3,15,Campania
2021-01-26,SAR,1336,453,883,1296,27,12,0,0,0,1,27,1309,ITG,ITG2,20,Sardegna
2021-02-04,EMR,9924,3200,6724,6434,824,864,1674,128,0,0,1250,8674,ITH,ITH5,8,Emilia-Romagna
2021-04-11,CAL,4082,1860,2222,136,2,2000,50,1720,7,167,2142,1940,ITF,ITF6,18,Calabria
2021-02-21,VEN,4624,1204,3420,495,0,7,18,417,2,3685,4619,5,ITH,ITH3,5,Veneto
2021-03-07,SIC,9280,3465,5815,968,62,908,431,3396,216,3299,8196,1084,ITG,ITG1,19,Sicilia
2021-01-15,SIC,5079,2233,2846,2824,158,1618,479,0,0,0,5079,0,ITG,ITG1,19,Sicilia
2021-03-06,BAS,1351,535,816,296,118,52,57,383,186,259,757,594,ITF,ITF5,17,Basilicata
2021-01-22,BAS,67,24,43,6,0,60,0,1,0,0,67,0,ITF,ITF5,17,Basilicata
2021-03-31,LOM,41531,16822,24709,2561,1301,6113,1404,23882,75,6195,26530,15001,ITC,ITC4,3,Lombardia
2021-02-23,ABR,2784,1274,1510,324,22,401,215,1436,286,100,2773,11,ITF,ITF1,13,Abruzzo
2021-03-14,VEN,15142,5913,9229,2399,210,4982,100,3751,41,3659,14246,896,ITH,ITH3,5,Veneto
2021-01-05,UMB,850,428,422,847,0,3,0,0,0,0,850,0,ITI,ITI2,10,Umbria
2021-03-08,PAT,1397,433,964,65,15,17,0,1016,7,277,1044,353,ITH,ITH2,4,Provincia Autonoma Trento
2021-02-22,LAZ,11427,4977,6450,1779,123,186,473,5254,1390,2222,10926,501,ITI,ITI4,12,Lazio
2021-02-08,PAB,2,1,1,0,0,1,0,1,0,0,1,1,ITH,ITH1,4,Provincia Autonoma Bolzano / Bozen
2021-04-19,LOM,39190,17986,21204,734,251,30535,162,7145,80,283,32344,6846,ITC,ITC4,3,Lombardia
2021-01-23,PAT,577,334,243,487,2,0,88,0,0,0,388,189,ITH,ITH2,4,Provincia Autonoma Trento
2021-02-24,LAZ,12025,5190,6835,1798,428,509,337,5226,1327,2400,11034,991,ITI,ITI4,12,Lazio
2021-04-19,ABR,3838,1767,2071,49,1,2930,33,806,9,10,2385,1453,ITF,ITF1,13,Abruzzo
2021-04-10,LAZ,23551,10234,13317,3200,45,12974,111,7125,18,78,16408,7143,ITI,ITI4,12,Lazio
2021-03-26,SIC,17897,8329,9568,1071,40,9579,314,5528,57,1308,12378,5519,ITG,ITG1,19,Sicilia
2021-04-02,TOS,31585,13356,18229,296,52,11378,370,19375,108,6,23692,7893,ITI,ITI1,9,Toscana
2021-04-10,FVG,4939,2135,2804,157,126,2418,78,2072,12,76,3718,1221,ITH,ITH4,6,Friuli-Venezia Giulia
2021-04-03,TOS,14920,6599,8321,101,34,9908,99,4755,10,13,13795,1125,ITI,ITI1,9,Toscana
2021-02-18,TOS,8817,3285,5532,2924,1447,64,230,214,796,3142,7923,894,ITI,ITI1,9,Toscana
2021-04-18,ABR,5305,2492,2813,148,2,4461,12,659,4,19,4646,659,ITF,ITF1,13,Abruzzo
2021-01-16,SAR,1492,525,967,1282,165,44,0,0,0,1,1492,0,ITG,ITG2,20,Sardegna
2021-02-24,UMB,1520,565,955,1083,45,1,90,292,9,0,1505,15,ITI,ITI2,10,Umbria
2021-01-14,LIG,2982,1056,1926,1872,336,220,553,0,0,1,2982,0,ITC,ITC3,7,Liguria
2021-02-02,PAB,1745,506,1239,630,370,131,605,9,0,0,8,1737,ITH,ITH1,4,Provincia Autonoma Bolzano / Bozen
2021-03-04,ABR,5937,2359,3578,1171,14,521,93,2992,328,818,5015,922,ITF,ITF1,13,Abruzzo
2021-03-13,PUG,10071,3968,6103,2161,229,163,129,3839,228,3322,8343,1728,ITF,ITF4,16,Puglia
2021-02-09,PIE,7351,2309,5042,4155,1324,42,1830,0,0,0,722,6629,ITC,ITC1,1,Piemonte
2021-01-31,LIG,624,270,354,418,67,4,135,0,0,0,9,615,ITC,ITC3,7,Liguria
2021-04-18,UMB,1527,680,847,67,3,557,0,838,21,41,596,931,ITI,ITI2,10,Umbria
2021-04-11,SAR,5353,2422,2931,62,7,3409,0,1847,8,20,4233,1120,ITG,ITG2,20,Sardegna
2021-04-05,MAR,5693,2357,3336,253,5,2345,61,2261,10,758,4424,1269,ITI,ITI3,11,Marche
2021-03-27,PUG,11907,5610,6297,959,173,1897,68,7381,59,1370,6765,5142,ITF,ITF4,16,Puglia
2021-01-15,SAR,1563,573,990,1170,338,52,0,0,3,0,1563,0,ITG,ITG2,20,Sardegna
2021-04-17,VDA,635,405,230,8,0,581,0,44,0,2,633,2,ITC,ITC2,2,Valle d'Aosta / Vallée d'Aoste
2021-02-05,EMR,9309,2964,6345,6214,628,660,1610,196,0,1,1636,7673,ITH,ITH5,8,Emilia-Romagna
2021-03-18,LOM,27375,10945,16430,2194,1127,953,1517,21440,44,100,16177,11198,ITC,ITC4,3,Lombardia
2021-03-15,UMB,4595,1929,2666,1425,194,152,79,2340,142,263,2827,1768,ITI,ITI2,10,Umbria
2021-01-11,CAL,2154,1040,1114,1759,0,392,3,0,0,0,2154,0,ITF,ITF6,18,Calabria
2021-01-13,TOS,4062,1398,2664,3308,348,2,404,0,0,0,4062,0,ITI,ITI1,9,Toscana
2021-01-03,FVG,312,122,190,285,0,26,1,0,0,0,312,0,ITH,ITH4,6,Friuli-Venezia Giulia
2021-02-05,FVG,2613,784,1829,1612,511,0,490,0,0,0,90,2523,ITH,ITH4,6,Friuli-Venezia Giulia
2021-03-04,VEN,12793,4743,8050,3163,404,1357,1401,3414,222,2832,9374,3419,ITH,ITH3,5,Veneto
2021-02-04,MAR,2342,810,1532,1406,54,607,275,0,0,0,112,2230,ITI,ITI3,11,Marche
2021-03-02,BAS,791,381,410,110,23,55,5,184,201,213,656,135,ITF,ITF5,17,Basilicata
2021-04-05,PUG,12485,6070,6415,54,18,11423,0,954,7,29,11952,533,ITF,ITF4,16,Puglia
2021-02-10,SAR,1959,765,1194,1169,245,56,488,0,0,1,1441,518,ITG,ITG2,20,Sardegna
2021-04-02,PAB,2077,837,1240,189,64,828,60,919,0,17,720,1357,ITH,ITH1,4,Provincia Autonoma Bolzano / Bozen
2021-03-04,LOM,29287,12122,17165,6998,2282,4413,2140,11131,1947,376,20233,9054,ITC,ITC4,3,Lombardia
2021-01-11,PUG,3748,1587,2161,3216,324,25,175,0,6,2,3748,0,ITF,ITF4,16,Puglia
2021-01-29,MOL,421,136,285,227,23,59,109,0,0,3,6,415,ITF,ITF2,14,Molise
2021-02-11,BAS,951,401,550,200,95,74,107,471,4,0,868,83,ITF,ITF5,17,Basilicata
2021-02-28,TOS,1649,667,982,1111,201,1,78,0,249,9,922,727,ITI,ITI1,9,Toscana
2021-03-27,ABR,6119,2619,3500,189,11,1386,42,4235,40,216,3640,2479,ITF,ITF1,13,Abruzzo
2021-02-11,PIE,6764,2107,4657,3424,1137,190,2010,0,0,3,3006,3758,ITC,ITC1,1,Piemonte
2021-01-05,VDA,150,54,96,127,11,1,11,0,0,0,150,0,ITC,ITC2,2,Valle d'Aosta / Vallée d'Aoste
2021-04-06,MAR,8883,3696,5187,310,2,4867,67,1867,42,1728,8068,815,ITI,ITI3,11,Marche
2021-01-17,LOM,8289,3327,4962,5554,699,1751,244,36,5,0,8088,201,ITC,ITC4,3,Lombardia
2021-01-11,CAM,4072,1871,2201,2386,681,753,252,0,0,0,4072,0,ITF,ITF3,15,Campania
2021-02-08,EMR,5220,1527,3693,2840,379,316,1478,206,0,1,2313,2907,ITH,ITH5,8,Emilia-Romagna
2021-04-14,BAS,2076,1008,1068,34,0,1267,2,671,10,92,1391,685,ITF,ITF5,17,Basilicata
2021-01-20,PUG,1546,541,1005,781,125,13,627,0,0,0,1538,8,ITF,ITF4,16,Puglia
2021-02-08,SIC,4086,1759,2327,2346,188,1155,397,0,0,0,2128,1958,ITG,ITG1,19,Sicilia
2021-03-25,SAR,8338,3477,4861,815,152,1782,188,3588,251,1562,7035,1303,ITG,ITG2,20,Sardegna
2021-04-19,VEN,15856,6595,9261,605,57,5990,238,8793,2,171,2815,13041,ITH,ITH3,5,Veneto
2021-01-07,SIC,9173,4239,4934,7694,70,1199,210,0,0,0,9173,0,ITG,ITG1,19,Sicilia
2021-01-02,PUG,2948,1300,1648,2829,68,24,23,0,0,4,2948,0,ITF,ITF4,16,Puglia
2021-02-21,PUG,2172,472,1700,537,24,62,49,32,12,1456,2111,61,ITF,ITF4,16,Puglia
2021-01-16,PUG,2507,1033,1474,1682,299,7,518,0,0,1,2507,0,ITF,ITF4,16,Puglia
2021-02-02,PUG,4333,1839,2494,3623,377,13,317,0,0,3,592,3741,ITF,ITF4,16,Puglia
2021-01-08,VDA,299,130,169,240,35,8,16,0,0,0,299,0,ITC,ITC2,2,Valle d'Aosta / Vallée d'Aoste
2021-04-13,FVG,5794,2590,3204,267,210,3302,149,1843,5,18,4673,1121,ITH,ITH4,6,Friuli-Venezia Giulia
2021-01-12,BAS,217,88,129,87,22,9,99,0,0,0,217,0,ITF,ITF5,17,Basilicata
2021-02-16,SIC,4414,2300,2114,1465,207,1080,779,25,857,1,3947,467,ITG,ITG1,19,Sicilia
2021-02-23,LIG,3803,1559,2244,686,79,195,116,2724,2,1,3694,109,ITC,ITC3,7,Liguria
2021-01-10,CAL,929,524,405,830,0,99,0,0,0,0,929,0,ITF,ITF6,18,Calabria
2021-01-18,LOM,9128,2957,6171,5192,1942,107,1831,54,2,0,8146,982,ITC,ITC4,3,Lombardia
2021-03-12,VDA,529,175,354,14,7,96,7,148,2,255,303,226,ITC,ITC2,2,Valle d'Aosta / Vallée d'Aoste
2021-04-04,ABR,1625,766,859,94,7,1071,2,446,1,4,1496,129,ITF,ITF1,13,Abruzzo
2021-03-26,ABR,5303,2269,3034,264,1,1061,37,3327,164,449,3242,2061,ITF,ITF1,13,Abruzzo
2021-03-17,CAM,11585,5096,6489,490,123,748,49,10005,33,137,5006,6579,ITF,ITF3,15,Campania
2021-03-27,LIG,3920,1538,2382,176,22,854,36,2057,69,706,2525,1395,ITC,ITC3,7,Liguria
2021-01-26,UMB,814,390,424,813,1,0,0,0,0,0,18,796,ITI,ITI2,10,Umbria
2021-01-15,PAT,594,131,463,463,18,2,111,0,0,0,594,0,ITH,ITH2,4,Provincia Autonoma Trento
2021-01-12,VDA,302,72,230,242,34,15,11,0,0,0,302,0,ITC,ITC2,2,Valle d'Aosta / Vallée d'Aoste
2021-01-31,UMB,1056,276,780,765,10,0,281,0,0,0,25,1031,ITI,ITI2,10,Umbria
2021-03-31,LIG,11386,4988,6398,522,85,5439,83,4206,179,872,8624,2762,ITC,ITC3,7,Liguria
2021-01-05,SAR,1327,446,881,1283,33,11,0,0,0,0,1327,0,ITG,ITG2,20,Sardegna
2021-02-11,MAR,1988,658,1330,1155,15,606,212,0,0,0,1599,389,ITI,ITI3,11,Marche
2021-01-20,TOS,1331,637,694,435,255,1,640,0,0,0,1083,248,ITI,ITI1,9,Toscana
2021-01-13,SIC,5204,2462,2742,3033,169,1561,441,0,0,0,5204,0,ITG,ITG1,19,Sicilia
2021-03-04,BAS,1872,889,983,217,107,136,66,842,263,241,1079,793,ITF,ITF5,17,Basilicata
2021-03-04,SIC,15213,6559,8654,2811,187,2635,698,3928,1124,3830,11009,4204,ITG,ITG1,19,Sicilia
2021-03-05,SIC,15947,6877,9070,3192,177,2348,720,4002,1423,4085,11622,4325,ITG,ITG1,19,Sicilia
2021-04-03,LOM,35839,14705,21134,960,220,5056,85,27204,78,2236,25822,10017,ITC,ITC4,3,Lombardia
2021-02-17,CAL,1682,672,1010,674,21,322,285,299,0,81,1471,211,ITF,ITF6,18,Calabria
2021-02-22,ABR,2644,1175,1469,477,5,352,46,1094,419,251,2614,30,ITF,ITF1,13,Abruzzo
2021-04-16,FVG,6146,2682,3464,274,174,3604,161,1919,0,14,4411,1735,ITH,ITH4,6,Friuli-Venezia Giulia
2021-04-13,UMB,7630,3378,4252,218,17,4478,21,2875,2,19,5961,1669,ITI,ITI2,10,Umbria
2021-03-31,PAB,1831,693,1138,420,300,647,16,426,6,16,818,1013,ITH,ITH1,4,Provincia Autonoma Bolzano / Bozen
2021-02-02,VEN,6403,1843,4560,2974,534,746,1994,152,0,3,390,6013,ITH,ITH3,5,Veneto
2021-01-14,LAZ,5269,1985,3284,3887,304,167,811,100,0,0,5269,0,ITI,ITI4,12,Lazio
2021-03-16,VDA,176,36,140,2,0,43,13,118,0,0,115,61,ITC,ITC2,2,Valle d'Aosta / Vallée d'Aoste
2021-02-17,PAT,1110,425,685,326,9,17,35,708,3,12,1020,90,ITH,ITH2,4,Provincia Autonoma Trento
2021-03-24,FVG,3737,1518,2219,182,176,433,140,2318,61,427,2255,1482,ITH,ITH4,6,Friuli-Venezia Giulia
2021-02-03,EMR,9296,2983,6313,6232,701,640,1618,105,0,0,973,8323,ITH,ITH5,8,Emilia-Romagna
2021-03-08,PAB,1200,526,674,23,10,278,166,720,0,3,1173,27,ITH,ITH1,4,Provincia Autonoma Bolzano / Bozen
2021-03-01,CAM,12122,4245,7877,1153,306,1665,147,3065,0,5786,8011,4111,ITF,ITF3,15,Campania
2021-02-04,CAM,7943,3429,4514,3965,1245,2440,292,1,0,0,1308,6635,ITF,ITF3,15,Campania
2021-03-30,UMB,3939,1703,2236,179,27,537,108,3068,0,20,2407,1532,ITI,ITI2,10,Umbria
2021-03-17,PIE,12508,5049,7459,2083,718,365,236,9097,0,9,5221,7287,ITC,ITC1,1,Piemonte
2021-04-15,LOM,48011,21302,26709,1064,503,32598,980,12161,52,653,34400,13611,ITC,ITC4,3,Lombardia
2021-01-20,UMB,613,222,391,583,14,1,14,0,0,1,613,0,ITI,ITI2,10,Umbria
2021-03-23,PAT,2426,938,1488,145,96,916,71,1002,34,162,1695,731,ITH,ITH2,4,Provincia Autonoma Trento
2021-01-16,EMR,5592,1717,3875,3687,347,446,1108,0,3,1,5592,0,ITH,ITH5,8,Emilia-Romagna
2021-01-16,LOM,15357,5706,9651,8615,1232,3850,1505,152,3,0,15357,0,ITC,ITC4,3,Lombardia
2021-04-08,LIG,9550,4326,5224,442,110,5759,71,2787,33,348,8049,1501,ITC,ITC3,7,Liguria
2021-04-18,VEN,17227,7149,10078,503,28,9250,66,7260,10,110,9682,7545,ITH,ITH3,5,Veneto
2021-03-24,PAT,2360,935,1425,206,77,329,42,1440,42,224,1541,819,ITH,ITH2,4,Provincia Autonoma Trento
2021-03-02,LIG,4073,1688,2385,726,60,126,76,3080,1,4,3763,310,ITC,ITC3,7,Liguria
2021-03-12,EMR,18065,7525,10540,1584,366,1582,302,9867,1340,3024,11349,6716,ITH,ITH5,8,Emilia-Romagna
2021-03-14,PIE,8200,3331,4869,794,230,370,2,5813,1,990,5307,2893,ITC,ITC1,1,Piemonte
2021-04-03,CAL,8822,3789,5033,363,3,2618,353,4821,42,622,4203,4619,ITF,ITF6,18,Calabria
2021-02-20,BAS,1160,530,630,77,170,31,80,802,0,0,1043,117,ITF,ITF5,17,Basilicata
2021-01-14,PAB,1905,567,1338,520,430,360,290,305,0,0,1905,0,ITH,ITH1,4,Provincia Autonoma Bolzano / Bozen
2021-02-07,VEN,2314,861,1453,1972,11,277,50,2,0,2,714,1600,ITH,ITH3,5,Veneto
2021-03-22,LAZ,21385,8895,12490,1532,75,6011,245,9144,517,3861,14949,6436,ITI,ITI4,12,Lazio
2021-02-28,SIC,7181,3072,4109,871,33,1280,93,3291,254,1359,6551,630,ITG,ITG1,19,Sicilia
2021-03-17,PUG,10245,4676,5569,1791,431,212,62,7644,33,72,4143,6102,ITF,ITF4,16,Puglia
2021-03-16,LAZ,13496,5718,7778,1504,69,2147,280,9484,7,5,7063,6433,ITI,ITI4,12,Lazio
2020-12-30,LAZ,1630,629,1001,1603,0,0,27,0,0,0,1630,0,ITI,ITI4,12,Lazio
2021-03-15,TOS,8312,3309,5003,3214,1248,709,404,36,420,2281,3870,4442,ITI,ITI1,9,Toscana
2021-02-06,CAL,2910,1338,1572,2095,30,537,248,0,0,0,442,2468,ITF,ITF6,18,Calabria
2021-03-10,MOL,1737,720,1017,188,3,92,1,757,187,509,1687,50,ITF,ITF2,14,Molise
2021-01-04,VEN,6729,2030,4699,5251,181,377,913,1,0,6,6729,0,ITH,ITH3,5,Veneto
2021-03-01,FVG,2958,1042,1916,93,32,68,176,1636,4,949,2905,53,ITH,ITH4,6,Friuli-Venezia Giulia
2021-02-19,MAR,1971,716,1255,1273,11,481,203,1,0,2,1836,135,ITI,ITI3,11,Marche
2021-03-17,PAT,2064,792,1272,399,15,325,55,1259,1,10,1191,873,ITH,ITH2,4,Provincia Autonoma Trento
2021-04-07,SIC,15753,7762,7991,764,114,9768,466,4425,34,182,8585,7168,ITG,ITG1,19,Sicilia
2021-02-18,MAR,2104,746,1358,1150,41,509,402,1,0,1,1816,288,ITI,ITI3,11,Marche
2021-04-05,LOM,27040,11559,15481,537,243,2033,69,23440,26,692,19188,7852,ITC,ITC4,3,Lombardia
2021-03-02,PAT,1301,440,861,137,16,24,53,924,1,146,925,376,ITH,ITH2,4,Provincia Autonoma Trento
2021-01-17,LAZ,4673,1896,2777,3243,145,253,177,855,0,0,4461,212,ITI,ITI4,12,Lazio
2021-03-27,MAR,7419,3082,4337,278,1,2495,135,3729,70,711,5050,2369,ITI,ITI3,11,Marche
2021-01-16,SIC,2776,1195,1581,1329,165,984,298,0,0,0,2776,0,ITG,ITG1,19,Sicilia
2021-01-28,PUG,5465,2271,3194,4782,323,24,327,0,6,3,473,4992,ITF,ITF4,16,Puglia
2021-02-27,VDA,230,84,146,69,2,25,2,128,4,0,124,106,ITC,ITC2,2,Valle d'Aosta / Vallée d'Aoste
2021-03-25,BAS,1721,575,1146,38,0,110,0,914,22,637,1409,312,ITF,ITF5,17,Basilicata
2021-04-11,PUG,15551,6822,8729,331,36,9634,12,5416,12,110,13877,1674,ITF,ITF4,16,Puglia
2021-04-04,SIC,6982,3379,3603,192,33,4100,119,2486,8,44,5689,1293,ITG,ITG1,19,Sicilia
2021-03-16,BAS,1899,799,1100,103,27,31,0,1671,5,62,228,1671,ITF,ITF5,17,Basilicata
2021-02-26,PUG,13646,4999,8647,2125,625,187,287,5159,604,4659,12619,1027,ITF,ITF4,16,Puglia
2021-02-01,LOM,16040,5313,10727,11670,3317,106,902,43,1,1,324,15716,ITC,ITC4,3,Lombardia
2021-02-24,SAR,2410,1292,1118,1193,311,303,301,3,299,0,2221,189,ITG,ITG2,20,Sardegna
2021-01-31,MAR,1928,772,1156,1532,0,396,0,0,0,0,105,1823,ITI,ITI3,11,Marche
2021-02-15,PIE,4431,1596,2835,2320,843,303,962,1,1,1,3226,1205,ITC,ITC1,1,Piemonte
2021-03-03,LIG,4578,1846,2732,1039,118,128,308,2978,3,4,3555,1023,ITC,ITC3,7,Liguria
2021-01-16,UMB,221,73,148,146,32,0,43,0,0,0,221,0,ITI,ITI2,10,Umbria
2021-03-23,ABR,4852,2210,2642,180,25,505,183,3353,206,400,2283,2569,ITF,ITF1,13,Abruzzo
2021-01-15,TOS,3878,1347,2531,2758,674,2,444,0,0,0,3878,0,ITI,ITI1,9,Toscana
2021-01-14,MAR,2010,692,1318,1112,67,533,298,0,0,0,2010,0,ITI,ITI3,11,Marche
2021-01-02,VDA,6,5,1,0,0,0,6,0,0,0,6,0,ITC,ITC2,2,Valle d'Aosta / Vallée d'Aoste
2021-01-04,PUG,4503,2012,2491,4372,86,33,11,0,0,1,4503,0,ITF,ITF4,16,Puglia
2021-01-29,FVG,2413,813,1600,1855,0,321,237,0,0,0,264,2149,ITH,ITH4,6,Friuli-Venezia Giulia
2021-03-15,EMR,13168,6040,7128,799,202,1375,178,9108,977,529,6718,6450,ITH,ITH5,8,Emilia-Romagna
2021-04-17,MOL,1597,792,805,5,2,1104,0,481,2,3,913,684,ITF,ITF2,14,Molise
2021-03-22,FVG,3520,1336,2184,149,86,139,206,2471,6,463,1566,1954,ITH,ITH4,6,Friuli-Venezia Giulia
2021-03-29,EMR,21067,9382,11685,691,149,10179,114,9222,94,618,16463,4604,ITH,ITH5,8,Emilia-Romagna
2021-01-15,PAB,3276,1226,2050,607,307,740,342,1280,0,0,3276,0,ITH,ITH1,4,Provincia Autonoma Bolzano / Bozen
2021-02-05,CAL,3796,1709,2087,2327,298,617,554,0,0,0,488,3308,ITF,ITF6,18,Calabria
2021-01-18,VEN,2763,777,1986,1224,234,304,992,8,0,1,2564,199,ITH,ITH3,5,Veneto
2021-02-10,MAR,1439,452,987,881,26,317,215,0,0,0,1080,359,ITI,ITI3,11,Marche
2021-03-27,UMB,4247,1510,2737,752,154,508,1,2232,24,576,3907,340,ITI,ITI2,10,Umbria
2021-01-09,SIC,7326,3424,3902,5034,146,1690,456,0,0,0,7326,0,ITG,ITG1,19,Sicilia
2021-02-20,SAR,2041,855,1186,484,128,29,195,1204,0,1,1707,334,ITG,ITG2,20,Sardegna
2021-02-22,VEN,6988,3028,3960,754,45,204,342,5400,0,243,6601,387,ITH,ITH3,5,Veneto
2021-01-22,MAR,487,167,320,315,19,66,87,0,0,0,194,293,ITI,ITI3,11,Marche
2021-02-26,LIG,3760,1521,2239,782,127,96,168,2585,0,2,3433,327,ITC,ITC3,7,Liguria
2021-02-05,LOM,25326,7374,17952,14335,6070,184,4477,259,1,0,2379,22947,ITC,ITC4,3,Lombardia
2021-02-15,SAR,958,349,609,440,226,13,279,0,0,0,927,31,ITG,ITG2,20,Sardegna
2021-03-11,PUG,14333,6172,8161,2906,754,446,515,5231,805,3676,11231,3102,ITF,ITF4,16,Puglia
2021-03-04,UMB,4485,1853,2632,849,164,72,4,1562,368,1466,3657,828,ITI,ITI2,10,Umbria
2021-03-31,SIC,14593,6732,7861,646,50,7997,520,5139,52,189,9565,5028,ITG,ITG1,19,Sicilia
2021-02-21,PAT,155,92,63,154,0,0,0,0,0,1,43,112,ITH,ITH2,4,Provincia Autonoma Trento
2021-04-12,PAB,2101,943,1158,32,11,1963,0,93,0,2,2095,6,ITH,ITH1,4,Provincia Autonoma Bolzano / Bozen
2021-04-08,EMR,30458,13961,16497,2473,376,16170,168,10901,60,310,25193,5265,ITH,ITH5,8,Emilia-Romagna
2021-02-07,CAL,860,428,432,567,15,197,81,0,0,0,147,713,ITF,ITF6,18,Calabria
2021-02-08,VEN,4973,1540,3433,2820,274,686,1177,12,0,4,1930,3043,ITH,ITH3,5,Veneto
2021-01-13,ABR,1253,440,813,1103,0,150,0,0,0,0,1253,0,ITF,ITF1,13,Abruzzo
2021-04-02,UMB,4236,1694,2542,375,76,2518,46,859,31,331,3509,727,ITI,ITI2,10,Umbria
2021-03-29,MOL,1996,826,1170,108,5,857,5,480,16,525,1510,486,ITF,ITF2,14,Molise
2021-03-24,LOM,43023,15514,27509,2968,1294,4121,1492,20221,434,12493,31329,11694,ITC,ITC4,3,Lombardia
2020-12-31,VDA,18,4,14,16,2,0,0,0,0,0,18,0,ITC,ITC2,2,Valle d'Aosta / Vallée d'Aoste
2021-01-23,CAL,400,186,214,325,1,51,23,0,0,0,358,42,ITF,ITF6,18,Calabria
2021-03-07,ABR,2523,630,1893,28,0,210,0,461,1,1823,2523,0,ITF,ITF1,13,Abruzzo
2021-03-24,ABR,6424,2831,3593,485,10,1763,143,3378,215,430,4168,2256,ITF,ITF1,13,Abruzzo
2021-01-23,BAS,707,299,408,592,38,76,1,0,0,0,33,674,ITF,ITF5,17,Basilicata
2021-03-14,MAR,2517,1036,1481,442,0,80,0,1537,2,456,1919,598,ITI,ITI3,11,Marche
2021-04-10,LOM,50248,20912,29336,851,514,9983,310,37079,46,1465,38535,11713,ITC,ITC4,3,Lombardia
2021-01-31,TOS,3049,1129,1920,2465,133,2,448,1,0,0,106,2943,ITI,ITI1,9,Toscana
2021-03-20,PAB,1757,848,909,115,47,619,9,961,5,1,1132,625,ITH,ITH1,4,Provincia Autonoma Bolzano / Bozen
2021-03-14,VDA,390,200,190,6,3,295,0,0,34,52,390,0,ITC,ITC2,2,Valle d'Aosta / Vallée d'Aoste
2021-03-22,LOM,40023,14179,25844,2457,1318,2409,802,20450,446,12141,29673,10350,ITC,ITC4,3,Lombardia
2021-03-25,CAL,7001,3315,3686,291,34,2933,428,2158,57,1100,4484,2517,ITF,ITF6,18,Calabria
2021-02-12,PAB,730,217,513,322,69,223,106,8,2,0,482,248,ITH,ITH1,4,Provincia Autonoma Bolzano / Bozen
2021-03-05,MAR,6292,2955,3337,1128,13,866,143,2378,961,803,4825,1467,ITI,ITI3,11,Marche
2021-04-01,TOS,26596,10953,15643,246,106,1569,303,24218,148,6,16074,10522,ITI,ITI1,9,Toscana
2021-01-20,PAT,290,72,218,231,10,1,48,0,0,0,278,12,ITH,ITH2,4,Provincia Autonoma Trento
2021-03-23,LOM,42325,15339,26986,2236,1348,3346,1280,21282,324,12509,29563,12762,ITC,ITC4,3,Lombardia
2021-01-02,PAT,502,143,359,336,21,4,141,0,0,0,502,0,ITH,ITH2,4,Provincia Autonoma Trento
2021-04-16,CAM,34281,16549,17732,236,35,26772,108,6614,203,313,23628,10653,ITF,ITF3,15,Campania
2021-02-21,TOS,5105,2089,3016,3666,1220,0,195,2,13,9,4935,170,ITI,ITI1,9,Toscana
2021-04-09,BAS,1146,351,795,142,0,200,0,137,49,618,1079,67,ITF,ITF5,17,Basilicata
2021-02-10,CAL,2463,1074,1389,1469,66,571,357,0,0,0,839,1624,ITF,ITF6,18,Calabria
2021-03-02,PIE,11192,4502,6690,907,317,815,215,6415,6,2517,10376,816,ITC,ITC1,1,Piemonte
2021-03-07,PIE,11967,4656,7311,1322,727,420,111,7337,0,2050,11087,880,ITC,ITC1,1,Piemonte
2021-03-30,ABR,5059,2199,2860,211,2,1749,31,2741,39,286,3234,1825,ITF,ITF1,13,Abruzzo
2021-01-14,PIE,9761,3150,6611,6175,2006,96,1484,0,0,0,9761,0,ITC,ITC1,1,Piemonte
2021-03-10,LAZ,21871,9412,12459,4077,143,2497,452,8906,1179,4617,16234,5637,ITI,ITI4,12,Lazio
2021-02-15,CAL,1137,538,599,499,26,386,159,66,0,1,989,148,ITF,ITF6,18,Calabria
2021-04-18,FVG,5300,2457,2843,252,30,4358,0,658,0,2,4894,406,ITH,ITH4,6,Friuli-Venezia Giulia
2021-03-01,LIG,3498,1425,2073,528,62,58,105,2744,0,1,3376,122,ITC,ITC3,7,Liguria
2021-01-09,MOL,450,152,298,221,27,24,178,0,0,0,450,0,ITF,ITF2,14,Molise
2021-03-23,FVG,3747,1555,2192,321,297,169,242,2448,29,241,1605,2142,ITH,ITH4,6,Friuli-Venezia Giulia
2021-04-04,VDA,569,251,318,1,8,446,0,20,0,94,568,1,ITC,ITC2,2,Valle d'Aosta / Vallée d'Aoste
2021-02-04,PIE,10198,3337,6861,6235,2130,70,1763,0,0,0,588,9610,ITC,ITC1,1,Piemonte
2021-02-11,VDA,231,107,124,53,17,20,0,128,13,0,222,9,ITC,ITC2,2,Valle d'Aosta / Vallée d'Aoste
2021-04-05,BAS,437,166,271,2,0,25,0,338,1,71,135,302,ITF,ITF5,17,Basilicata
2021-01-10,PAB,2,2,0,1,0,1,0,0,0,0,2,0,ITH,ITH1,4,Provincia Autonoma Bolzano / Bozen
2020-12-27,PUG,506,249,257,403,3,37,63,0,0,0,506,0,ITF,ITF4,16,Puglia
2021-03-30,LIG,11700,5170,6530,485,94,5650,106,4292,228,845,8311,3389,ITC,ITC3,7,Liguria
2021-03-12,ABR,6024,1990,4034,1006,28,848,135,1701,117,2189,4441,1583,ITF,ITF1,13,Abruzzo
2021-03-20,MOL,2320,968,1352,28,2,206,0,1855,7,222,999,1321,ITF,ITF2,14,Molise
2021-02-16,MOL,156,70,86,148,4,4,0,0,0,0,150,6,ITF,ITF2,14,Molise
2021-03-31,CAM,22666,10896,11770,340,35,15731,111,5151,134,1164,19228,3438,ITF,ITF3,15,Campania
2021-02-17,MOL,72,32,40,47,9,10,6,0,0,0,57,15,ITF,ITF2,14,Molise
2021-04-02,ABR,6684,3094,3590,184,2,3074,2,3306,22,94,5197,1487,ITF,ITF1,13,Abruzzo
2020-12-27,PAT,103,40,63,76,4,2,21,0,0,0,103,0,ITH,ITH2,4,Provincia Autonoma Trento
2021-03-08,LIG,5619,2456,3163,1122,172,365,80,3567,306,7,3935,1684,ITC,ITC3,7,Liguria
2021-04-03,SAR,4329,1673,2656,181,174,964,61,2508,17,424,2586,1743,ITG,ITG2,20,Sardegna
2021-02-22,MAR,3414,1499,1915,326,10,398,77,2596,5,2,3339,75,ITI,ITI3,11,Marche
2021-04-10,MAR,10997,4655,6342,312,8,7317,50,2187,21,1102,10678,319,ITI,ITI3,11,Marche
2021-01-03,UMB,267,111,156,267,0,0,0,0,0,0,267,0,ITI,ITI2,10,Umbria
2021-03-03,FVG,3642,1628,2014,750,493,72,100,1331,469,427,2364,1278,ITH,ITH4,6,Friuli-Venezia Giulia
2021-02-07,MOL,66,32,34,49,1,0,16,0,0,0,19,47,ITF,ITF2,14,Molise
2021-04-08,PAB,2746,1334,1412,47,31,2472,118,75,1,2,2549,197,ITH,ITH1,4,Provincia Autonoma Bolzano / Bozen
2021-03-16,MAR,3577,1549,2028,317,3,193,54,2928,77,5,394,3183,ITI,ITI3,11,Marche
2021-03-02,CAM,12745,4550,8195,1294,193,1978,147,3232,2,5899,8401,4344,ITF,ITF3,15,Campania
2021-04-01,EMR,23716,10673,13043,1009,117,10334,115,11085,66,990,19252,4464,ITH,ITH5,8,Emilia-Romagna
2020-12-27,SAR,65,34,31,65,0,0,0,0,0,0,65,0,ITG,ITG2,20,Sardegna
2021-01-06,CAL,926,500,426,822,0,104,0,0,0,0,926,0,ITF,ITF6,18,Calabria
2020-12-27,FVG,262,149,113,259,0,3,0,0,0,0,262,0,ITH,ITH4,6,Friuli-Venezia Giulia
2021-02-12,UMB,671,224,447,459,208,0,1,1,0,2,665,6,ITI,ITI2,10,Umbria
2021-03-06,LOM,21308,9081,12227,4764,1850,4339,451,7522,1025,1357,16791,4517,ITC,ITC4,3,Lombardia
2021-01-19,EMR,2033,500,1533,745,84,51,1153,0,0,0,2016,17,ITH,ITH5,8,Emilia-Romagna
2021-01-23,CAM,3838,2028,1810,3161,343,265,69,0,0,0,273,3565,ITF,ITF3,15,Campania
2021-01-18,EMR,3126,879,2247,1681,102,214,1129,0,0,0,2449,677,ITH,ITH5,8,Emilia-Romagna
2021-01-16,ABR,927,428,499,710,7,195,15,0,0,0,927,0,ITF,ITF1,13,Abruzzo
2021-01-24,SIC,4338,2264,2074,3993,31,311,3,0,0,0,148,4190,ITG,ITG1,19,Sicilia
2021-04-17,FVG,6437,2807,3630,250,63,3912,1,2206,2,3,5115,1322,ITH,ITH4,6,Friuli-Venezia Giulia
2021-01-22,UMB,276,105,171,273,1,0,2,0,0,0,32,244,ITI,ITI2,10,Umbria
2021-03-27,LOM,32126,12244,19882,1973,1128,3868,252,18176,66,6663,23531,8595,ITC,ITC4,3,Lombardia
2021-04-04,MAR,3826,1793,2033,189,0,1539,0,2009,5,84,2655,1171,ITI,ITI3,11,Marche
2021-04-17,LIG,6808,2980,3828,153,49,5060,68,1472,3,3,6085,723,ITC,ITC3,7,Liguria
2021-03-02,PAB,684,194,490,1,0,0,0,0,7,676,684,0,ITH,ITH1,4,Provincia Autonoma Bolzano / Bozen
2021-02-06,FVG,1154,338,816,755,208,0,191,0,0,0,22,1132,ITH,ITH4,6,Friuli-Venezia Giulia
2021-03-08,UMB,3668,1799,1869,141,273,81,46,2855,230,42,2305,1363,ITI,ITI2,10,Umbria
2021-02-14,BAS,151,48,103,55,12,1,65,18,0,0,151,0,ITF,ITF5,17,Basilicata
2021-01-09,LIG,1335,481,854,999,73,73,188,0,0,2,1335,0,ITC,ITC3,7,Liguria
2021-01-09,PAB,612,326,286,76,28,422,74,12,0,0,612,0,ITH,ITH1,4,Provincia Autonoma Bolzano / Bozen
2021-04-06,SAR,7093,2955,4138,656,79,3200,168,2504,31,455,4969,2124,ITG,ITG2,20,Sardegna
2021-03-20,SAR,5190,2073,3117,696,255,435,127,2717,105,855,2914,2276,ITG,ITG2,20,Sardegna
2021-01-23,SIC,4151,2149,2002,3914,33,188,16,0,0,0,225,3926,ITG,ITG1,19,Sicilia
2021-03-31,FVG,7979,3475,4504,168,85,4289,289,2157,112,879,7130,849,ITH,ITH4,6,Friuli-Venezia Giulia
2021-04-17,MAR,11635,5275,6360,203,12,9866,21,911,8,614,10560,1075,ITI,ITI3,11,Marche
2021-01-09,BAS,557,160,397,386,52,51,67,0,0,1,557,0,ITF,ITF5,17,Basilicata
2021-03-28,SAR,4499,1773,2726,83,19,487,21,3196,12,681,4421,78,ITG,ITG2,20,Sardegna
2021-02-15,BAS,621,232,389,191,93,44,46,246,1,0,580,41,ITF,ITF5,17,Basilicata
2021-03-03,CAL,4871,2655,2216,631,110,1047,917,1369,793,4,3808,1063,ITF,ITF6,18,Calabria
2021-03-18,VDA,134,43,91,4,0,3,25,101,1,0,98,36,ITC,ITC2,2,Valle d'Aosta / Vallée d'Aoste
2020-12-30,VEN,699,245,454,598,12,48,39,0,0,2,699,0,ITH,ITH3,5,Veneto
2021-02-26,PAT,1218,435,783,250,12,11,19,820,1,105,923,295,ITH,ITH2,4,Provincia Autonoma Trento
2021-04-06,CAL,7202,3230,3972,376,6,3091,444,2448,33,804,4134,3068,ITF,ITF6,18,Calabria
2021-03-29,PAB,989,423,566,10,2,230,0,709,25,13,230,759,ITH,ITH1,4,Provincia Autonoma Bolzano / Bozen
2021-03-10,MAR,5783,2490,3293,721,22,799,101,2675,424,1041,4646,1137,ITI,ITI3,11,Marche
2021-02-11,SIC,5332,2103,3229,2458,307,1677,890,0,0,0,4868,464,ITG,ITG1,19,Sicilia
2021-04-02,FVG,6431,2855,3576,356,237,2655,76,3094,10,3,4612,1819,ITH,ITH4,6,Friuli-Venezia Giulia
2021-02-04,CAL,3391,1623,1768,2560,38,571,222,0,0,0,644,2747,ITF,ITF6,18,Calabria
2021-04-09,LAZ,26789,12016,14773,4707,132,13991,162,7603,129,65,18648,8141,ITI,ITI4,12,Lazio
2021-03-02,PUG,16277,6037,10240,1396,396,660,113,4289,1257,8166,14972,1305,ITF,ITF4,16,Puglia
2021-01-18,MAR,673,230,443,370,5,166,132,0,0,0,547,126,ITI,ITI3,11,Marche
2021-02-27,MOL,1366,568,798,25,2,34,14,1290,0,1,1347,19,ITF,ITF2,14,Molise
2021-04-01,UMB,4123,1702,2421,193,12,515,239,3142,3,19,2152,1971,ITI,ITI2,10,Umbria
2021-01-19,PUG,1221,452,769,531,113,0,577,0,0,0,1211,10,ITF,ITF4,16,Puglia
2021-04-17,CAL,10601,4975,5626,211,15,7907,203,2124,23,118,8921,1680,ITF,ITF6,18,Calabria
2021-04-02,LAZ,27811,12991,14820,5762,89,12894,166,8495,221,184,20550,7261,ITI,ITI4,12,Lazio
2021-03-20,LAZ,18144,6787,11357,1840,139,3766,360,8788,204,3047,12308,5836,ITI,ITI4,12,Lazio
2021-01-17,SAR,860,277,583,747,113,0,0,0,0,0,859,1,ITG,ITG2,20,Sardegna
2021-03-20,UMB,2272,821,1451,316,178,506,0,0,72,1200,2247,25,ITI,ITI2,10,Umbria
2021-03-19,SAR,7213,3005,4208,1315,444,1604,222,3428,190,10,5000,2213,ITG,ITG2,20,Sardegna
2021-04-07,PAT,2548,999,1549,258,27,794,29,1330,9,101,1631,917,ITH,ITH2,4,Provincia Autonoma Trento
2021-04-08,PAT,3068,1280,1788,182,25,1402,46,1373,2,38,1981,1087,ITH,ITH2,4,Provincia Autonoma Trento
2021-01-27,PIE,4196,1453,2743,2983,541,115,557,0,0,0,999,3197,ITC,ITC1,1,Piemonte
2021-03-19,PAB,1903,772,1131,158,53,563,15,1100,0,14,797,1106,ITH,ITH1,4,Provincia Autonoma Bolzano / Bozen
2021-03-15,PAB,848,295,553,293,94,386,13,56,2,4,366,482,ITH,ITH1,4,Provincia Autonoma Bolzano / Bozen
2021-01-24,ABR,50,22,28,49,0,1,0,0,0,0,6,44,ITF,ITF1,13,Abruzzo
2021-04-07,PUG,14524,6409,8115,1034,195,4202,76,8590,67,360,7921,6603,ITF,ITF4,16,Puglia
2021-04-01,SAR,9993,3981,6012,455,135,3314,204,4553,81,1251,6980,3013,ITG,ITG2,20,Sardegna
2021-01-21,TOS,1589,686,903,579,220,0,790,0,0,0,867,722,ITI,ITI1,9,Toscana
2021-04-06,SIC,18171,8720,9451,804,66,11036,562,5458,57,188,13848,4323,ITG,ITG1,19,Sicilia
2021-01-17,CAL,867,418,449,527,9,283,48,0,0,0,801,66,ITF,ITF6,18,Calabria
2021-01-22,VDA,56,21,35,36,0,0,20,0,0,0,20,36,ITC,ITC2,2,Valle d'Aosta / Vallée d'Aoste
2021-01-23,PUG,3037,1292,1745,2523,175,29,309,0,0,1,886,2151,ITF,ITF4,16,Puglia
2021-02-01,VEN,8518,2490,6028,4216,495,1428,2105,264,0,10,161,8357,ITH,ITH3,5,Veneto
2021-02-25,CAM,12422,4479,7943,803,119,907,124,5664,0,4805,11234,1188,ITF,ITF3,15,Campania
2021-01-12,EMR,9408,3111,6297,6376,593,750,1689,0,0,0,9408,0,ITH,ITH5,8,Emilia-Romagna
2021-01-14,BAS,969,413,556,504,110,32,323,0,0,0,969,0,ITF,ITF5,17,Basilicata
2021-02-22,PAB,526,143,383,342,66,102,0,5,1,10,514,12,ITH,ITH1,4,Provincia Autonoma Bolzano / Bozen
2021-01-24,LOM,1201,459,742,832,135,197,36,1,0,0,537,664,ITC,ITC4,3,Lombardia
2021-03-01,VDA,181,66,115,19,5,10,29,116,2,0,147,34,ITC,ITC2,2,Valle d'Aosta / Vallée d'Aoste
2021-03-30,FVG,7039,3116,3923,416,306,3796,393,1934,54,140,6119,920,ITH,ITH4,6,Friuli-Venezia Giulia
2021-03-25,PIE,17060,7189,9871,1035,509,1340,626,11996,179,1375,8425,8635,ITC,ITC1,1,Piemonte
2021-03-07,BAS,882,308,574,39,12,6,4,328,22,471,844,38,ITF,ITF5,17,Basilicata
2021-01-16,TOS,3271,1046,2225,2493,538,0,240,0,0,0,3271,0,ITI,ITI1,9,Toscana
2021-02-03,CAL,2763,1428,1335,2170,22,468,103,0,0,0,583,2180,ITF,ITF6,18,Calabria
2021-04-11,LIG,4204,1912,2292,66,13,3395,23,624,10,73,3955,249,ITC,ITC3,7,Liguria
2021-01-01,VEN,1527,471,1056,1496,0,27,1,0,0,3,1527,0,ITH,ITH3,5,Veneto
2021-02-13,LIG,1080,508,572,543,77,58,148,254,0,0,800,280,ITC,ITC3,7,Liguria
2021-02-09,MAR,125,42,83,78,0,21,26,0,0,0,47,78,ITI,ITI3,11,Marche
2021-04-01,PAT,2870,1223,1647,192,52,877,8,1613,3,125,1796,1074,ITH,ITH2,4,Provincia Autonoma Trento
2021-01-13,CAL,2028,1022,1006,1800,0,194,34,0,0,0,2028,0,ITF,ITF6,18,Calabria
2021-03-13,SAR,2751,1072,1679,274,103,294,145,1760,43,132,2470,281,ITG,ITG2,20,Sardegna
2021-03-04,PAB,1703,998,705,301,79,527,39,40,455,262,1474,229,ITH,ITH1,4,Provincia Autonoma Bolzano / Bozen
2021-03-01,MAR,3727,1489,2238,387,6,171,82,2790,5,286,3480,247,ITI,ITI3,11,Marche
2021-01-23,PIE,4256,1325,2931,3208,453,75,520,0,0,0,879,3377,ITC,ITC1,1,Piemonte
2021-04-15,MOL,1895,777,1118,3,1,1213,0,649,2,27,1057,838,ITF,ITF2,14,Molise
2021-03-11,PAT,2282,847,1435,105,50,63,41,1573,59,391,1470,812,ITH,ITH2,4,Provincia Autonoma Trento
2021-01-18,BAS,463,157,306,364,51,3,45,0,0,0,364,99,ITF,ITF5,17,Basilicata
2021-03-27,SAR,5496,2080,3416,331,135,1016,203,2487,15,1309,5074,422,ITG,ITG2,20,Sardegna
2021-02-18,LAZ,9694,4807,4887,2162,91,339,473,4963,1665,1,9180,514,ITI,ITI4,12,Lazio
2021-03-25,ABR,5689,2563,3126,249,10,946,39,3784,213,448,3073,2616,ITF,ITF1,13,Abruzzo
2021-02-22,EMR,7481,3091,4390,389,98,133,129,6732,0,0,7205,276,ITH,ITH5,8,Emilia-Romagna
2021-01-27,UMB,838,329,509,837,1,0,0,0,0,0,13,825,ITI,ITI2,10,Umbria
2021-03-08,SIC,13583,5848,7735,2013,113,2051,628,3845,932,4001,10769,2814,ITG,ITG1,19,Sicilia
2021-03-18,MOL,1156,476,680,73,10,174,45,854,0,0,692,464,ITF,ITF2,14,Molise
2021-01-30,FVG,2271,744,1527,1475,2,352,442,0,0,0,270,2001,ITH,ITH4,6,Friuli-Venezia Giulia
2021-04-19,EMR,12670,5997,6673,187,37,10187,68,2171,10,10,8554,4116,ITH,ITH5,8,Emilia-Romagna
2021-02-13,PAB,318,79,239,126,57,127,7,1,0,0,312,6,ITH,ITH1,4,Provincia Autonoma Bolzano / Bozen
2021-02-19,LAZ,9731,4906,4825,2170,93,315,408,5075,1636,34,9201,530,ITI,ITI4,12,Lazio
2021-03-29,SIC,14995,7036,7959,877,39,8420,328,5008,19,304,10477,4518,ITG,ITG1,19,Sicilia
2021-02-03,FVG,2646,790,1856,1701,558,0,386,1,0,0,23,2623,ITH,ITH4,6,Friuli-Venezia Giulia
2021-02-24,LIG,3758,1557,2201,804,92,182,154,2525,0,1,3499,259,ITC,ITC3,7,Liguria
2021-02-24,PAB,1365,405,960,10,3,0,0,0,8,1344,1353,12,ITH,ITH1,4,Provincia Autonoma Bolzano / Bozen
2021-04-07,BAS,1396,579,817,268,0,432,0,103,10,583,1361,35,ITF,ITF5,17,Basilicata
2021-01-10,VDA,220,71,149,172,25,4,19,0,0,0,220,0,ITC,ITC2,2,Valle d'Aosta / Vallée d'Aoste
2021-02-01,EMR,10300,3602,6698,7455,787,798,1260,0,0,0,366,9934,ITH,ITH5,8,Emilia-Romagna
2021-01-12,MOL,336,114,222,132,74,1,129,0,0,0,336,0,ITF,ITF2,14,Molise
2021-03-03,VDA,255,118,137,9,1,102,1,137,1,4,186,69,ITC,ITC2,2,Valle d'Aosta / Vallée d'Aoste
2021-02-04,TOS,4253,1594,2659,3168,623,1,456,5,0,0,961,3292,ITI,ITI1,9,Toscana
2021-03-05,MOL,1219,649,570,322,1,54,0,618,151,73,1015,204,ITF,ITF2,14,Molise
2021-01-15,PUG,4550,1865,2685,3598,346,31,558,0,13,4,4550,0,ITF,ITF4,16,Puglia
2021-03-26,TOS,20288,9110,11178,250,304,8011,213,11036,141,333,14586,5702,ITI,ITI1,9,Toscana
2021-04-17,LAZ,31472,13828,17644,819,76,21690,215,8613,6,53,19927,11545,ITI,ITI4,12,Lazio
2021-01-06,VDA,65,33,32,29,8,10,18,0,0,0,65,0,ITC,ITC2,2,Valle d'Aosta / Vallée d'Aoste
2021-01-19,VEN,1309,472,837,726,83,167,326,7,0,0,1160,149,ITH,ITH3,5,Veneto
2021-03-12,VEN,18539,8108,10431,2010,225,3778,755,8047,215,3509,11821,6718,ITH,ITH3,5,Veneto
2021-03-13,SIC,12464,5492,6972,1174,87,4193,493,4615,134,1768,7858,4606,ITG,ITG1,19,Sicilia
2021-03-30,MOL,1953,839,1114,45,0,830,1,573,80,424,1441,512,ITF,ITF2,14,Molise
2021-01-06,PIE,3116,1111,2005,2370,319,114,313,0,0,0,3116,0,ITC,ITC1,1,Piemonte
2021-03-13,BAS,1794,888,906,82,292,66,46,864,231,213,749,1045,ITF,ITF5,17,Basilicata
2021-04-16,CAL,10131,4955,5176,332,68,8206,272,965,55,233,8532,1599,ITF,ITF6,18,Calabria
2021-02-16,LIG,2392,949,1443,982,200,223,283,702,0,2,1999,393,ITC,ITC3,7,Liguria
2021-02-06,VDA,289,104,185,170,31,13,0,74,1,0,92,197,ITC,ITC2,2,Valle d'Aosta / Vallée d'Aoste
2021-01-31,ABR,1502,488,1014,1154,85,160,103,0,0,0,287,1215,ITF,ITF1,13,Abruzzo
2021-01-22,MOL,126,35,91,21,32,0,73,0,0,0,126,0,ITF,ITF2,14,Molise
2021-02-08,UMB,637,203,434,368,111,0,154,0,4,0,88,549,ITI,ITI2,10,Umbria
2021-01-31,LOM,9745,3763,5982,7576,2006,67,87,7,2,0,33,9712,ITC,ITC4,3,Lombardia
2021-02-04,SIC,6908,3174,3734,4429,188,1751,540,0,0,0,1460,5448,ITG,ITG1,19,Sicilia
2021-01-14,CAM,7073,2977,4096,3707,1264,1752,350,0,0,0,7073,0,ITF,ITF3,15,Campania
2021-01-27,ABR,1364,515,849,1301,1,62,0,0,0,0,39,1325,ITF,ITF1,13,Abruzzo
2021-02-09,BAS,491,213,278,200,225,12,54,0,0,0,316,175,ITF,ITF5,17,Basilicata
2021-01-10,EMR,7129,2664,4465,5646,652,325,499,6,0,1,7129,0,ITH,ITH5,8,Emilia-Romagna
2021-03-13,PAT,829,380,449,203,15,0,30,44,278,259,781,48,ITH,ITH2,4,Provincia Autonoma Trento
2021-03-09,ABR,5172,1796,3376,990,21,507,84,1320,204,2046,4233,939,ITF,ITF1,13,Abruzzo
2020-12-29,LAZ,488,176,312,486,2,0,0,0,0,0,488,0,ITI,ITI4,12,Lazio
2020-12-31,VEN,3218,1042,2176,2700,77,187,252,0,0,2,3218,0,ITH,ITH3,5,Veneto
2021-02-27,CAL,3680,1913,1767,421,37,551,395,1972,302,2,3302,378,ITF,ITF6,18,Calabria
2021-04-05,VEN,19138,8372,10766,622,7,12481,327,5517,8,176,13687,5451,ITH,ITH3,5,Veneto
2021-02-03,PUG,5031,2002,3029,4366,469,9,184,0,0,3,730,4301,ITF,ITF4,16,Puglia
2021-04-13,MOL,1615,710,905,7,4,1280,1,322,0,1,1028,587,ITF,ITF2,14,Molise
2021-03-27,TOS,8793,4100,4693,113,61,6760,225,1388,48,198,8578,215,ITI,ITI1,9,Toscana
2021-04-08,PUG,16800,7317,9483,1006,222,5270,157,9600,39,506,10756,6044,ITF,ITF4,16,Puglia
2021-04-11,MAR,7134,3123,4011,282,1,4797,0,1233,38,783,6848,286,ITI,ITI3,11,Marche
2021-02-06,CAM,5341,2665,2676,1990,520,2357,459,15,0,0,2103,3238,ITF,ITF3,15,Campania
2021-01-03,ABR,471,185,286,464,0,7,0,0,0,0,471,0,ITF,ITF1,13,Abruzzo
2021-01-23,SAR,60,22,38,60,0,0,0,0,0,0,0,60,ITG,ITG2,20,Sardegna
2021-03-15,ABR,3640,1399,2241,657,8,562,78,1964,41,330,1824,1816,ITF,ITF1,13,Abruzzo
2021-03-15,FVG,3762,1634,2128,328,253,107,180,2426,234,234,1442,2320,ITH,ITH4,6,Friuli-Venezia Giulia
2021-02-13,VEN,3267,1474,1793,1592,75,158,1438,3,0,1,3247,20,ITH,ITH3,5,Veneto
2021-04-09,PIE,25594,11249,14345,1217,463,12519,251,11074,24,46,21093,4501,ITC,ITC1,1,Piemonte
2021-02-12,SIC,4747,1853,2894,2301,260,1542,644,0,0,0,4416,331,ITG,ITG1,19,Sicilia
2021-04-03,FVG,3973,1966,2007,34,25,1498,0,2244,23,149,2647,1326,ITH,ITH4,6,Friuli-Venezia Giulia
2021-04-13,ABR,5726,2670,3056,92,9,4140,76,1255,5,149,4526,1200,ITF,ITF1,13,Abruzzo
2021-01-05,PAT,709,232,477,495,46,6,162,0,0,0,709,0,ITH,ITH2,4,Provincia Autonoma Trento
2021-03-02,CAL,4136,2395,1741,705,58,677,427,1390,877,2,3427,709,ITF,ITF6,18,Calabria
2021-01-12,SAR,865,408,457,504,88,273,0,0,0,0,865,0,ITG,ITG2,20,Sardegna
2021-04-09,ABR,8681,4084,4597,312,10,5029,29,3228,28,45,6198,2483,ITF,ITF1,13,Abruzzo
2021-03-28,MAR,4134,1744,2390,45,1,1032,5,2651,4,396,2439,1695,ITI,ITI3,11,Marche
2021-01-15,BAS,813,350,463,578,21,40,174,0,0,0,813,0,ITF,ITF5,17,Basilicata
2021-03-30,PAB,1298,532,766,51,4,133,153,920,10,27,218,1080,ITH,ITH1,4,Provincia Autonoma Bolzano / Bozen
2021-01-04,CAL,997,492,505,969,0,28,0,0,0,0,997,0,ITF,ITF6,18,Calabria
2021-04-07,ABR,7121,3283,3838,187,6,3544,79,3206,84,15,4395,2726,ITF,ITF1,13,Abruzzo
2021-02-10,UMB,715,349,366,606,106,0,3,0,0,0,700,15,ITI,ITI2,10,Umbria
2021-01-14,SAR,1105,426,679,885,167,53,0,0,0,0,1105,0,ITG,ITG2,20,Sardegna
2021-04-02,EMR,23161,10426,12735,717,157,12532,103,8636,84,932,18705,4456,ITH,ITH5,8,Emilia-Romagna
2021-01-24,EMR,2443,885,1558,2080,51,63,249,0,0,0,299,2144,ITH,ITH5,8,Emilia-Romagna
2021-01-09,MAR,1709,605,1104,1406,0,303,0,0,0,0,1709,0,ITI,ITI3,11,Marche
2021-02-16,TOS,9268,3338,5930,5084,952,30,178,10,691,2323,8557,711,ITI,ITI1,9,Toscana
2021-04-11,VDA,476,207,269,2,0,466,0,5,0,3,476,0,ITC,ITC2,2,Valle d'Aosta / Vallée d'Aoste
2021-04-04,TOS,13907,6599,7308,17,8,13796,1,30,3,52,13655,252,ITI,ITI1,9,Toscana
2021-01-10,CAM,8165,3736,4429,5179,1010,1879,97,0,0,0,8165,0,ITF,ITF3,15,Campania
2021-04-14,UMB,8058,3632,4426,226,20,4635,15,3138,5,19,6079,1979,ITI,ITI2,10,Umbria
2021-02-07,LOM,7204,2796,4408,5542,1285,60,293,17,2,5,339,6865,ITC,ITC4,3,Lombardia
2021-01-27,SIC,7534,3838,3696,6330,66,986,152,0,0,0,189,7345,ITG,ITG1,19,Sicilia
2021-02-27,LAZ,11381,4249,7132,1359,399,487,515,4798,1120,2703,10427,954,ITI,ITI4,12,Lazio
2021-03-01,TOS,4387,1671,2716,3192,593,10,137,9,421,25,747,3640,ITI,ITI1,9,Toscana
2021-04-02,SIC,14038,6608,7430,633,29,7638,367,5151,16,204,9251,4787,ITG,ITG1,19,Sicilia
2021-01-28,ABR,1433,495,938,1370,1,61,1,0,0,0,12,1421,ITF,ITF1,13,Abruzzo
2021-02-08,MOL,334,141,193,206,38,5,85,0,0,0,216,118,ITF,ITF2,14,Molise
2021-04-18,TOS,7767,3858,3909,313,74,6377,67,930,4,2,7002,765,ITI,ITI1,9,Toscana
2021-01-04,FVG,1510,559,951,1392,0,118,0,0,0,0,1510,0,ITH,ITH4,6,Friuli-Venezia Giulia
2021-04-13,LOM,46969,20985,25984,933,552,30689,676,13111,56,952,33039,13930,ITC,ITC4,3,Lombardia
2021-04-12,MAR,8579,3779,4800,179,7,5897,5,1315,19,1157,8092,487,ITI,ITI3,11,Marche
2021-01-05,CAM,7237,3638,3599,5810,923,398,106,0,0,0,7237,0,ITF,ITF3,15,Campania
2021-02-13,SIC,3107,1168,1939,1296,160,1081,570,0,0,0,2850,257,ITG,ITG1,19,Sicilia
2021-01-28,PIE,5588,1809,3779,4118,829,50,590,1,0,0,384,5204,ITC,ITC1,1,Piemonte
2021-01-25,SIC,7514,3698,3816,6635,14,795,70,0,0,0,322,7192,ITG,ITG1,19,Sicilia
2021-01-07,TOS,6018,1751,4267,5308,29,1,680,0,0,0,6018,0,ITI,ITI1,9,Toscana
2021-03-07,LOM,11910,5299,6611,3012,895,2125,82,4538,552,706,9350,2560,ITC,ITC4,3,Lombardia
2021-04-09,CAL,7819,3664,4155,342,23,4647,407,2071,23,306,4906,2913,ITF,ITF6,18,Calabria
2021-01-30,CAM,10721,5079,5642,6930,1278,2286,227,0,0,0,39,10682,ITF,ITF3,15,Campania
2021-01-22,LAZ,3716,1468,2248,3380,63,46,70,157,0,0,201,3515,ITI,ITI4,12,Lazio
2021-01-19,FVG,7,2,5,5,0,0,2,0,0,0,7,0,ITH,ITH4,6,Friuli-Venezia Giulia
2021-01-25,MAR,1596,559,1037,1426,12,102,56,0,0,0,97,1499,ITI,ITI3,11,Marche
2021-02-06,VEN,4091,1352,2739,3095,171,451,367,3,0,4,709,3382,ITH,ITH3,5,Veneto
2021-04-05,FVG,2862,1425,1437,34,22,2196,0,465,24,121,2846,16,ITH,ITH4,6,Friuli-Venezia Giulia
2021-01-07,MAR,1802,633,1169,1480,0,322,0,0,0,0,1802,0,ITI,ITI3,11,Marche
2021-03-07,SAR,1657,750,907,323,227,15,78,1012,0,2,1117,540,ITG,ITG2,20,Sardegna
2021-03-05,LAZ,18528,7816,10712,2729,171,1590,256,8490,1323,3969,13805,4723,ITI,ITI4,12,Lazio
2021-03-15,CAL,3508,1675,1833,542,38,894,136,1146,165,587,2079,1429,ITF,ITF6,18,Calabria
2021-03-19,MAR,3869,1604,2265,495,1,233,293,2837,4,6,343,3526,ITI,ITI3,11,Marche
2021-02-25,PIE,12209,5247,6962,1446,593,1476,405,6329,1,1959,11663,546,ITC,ITC1,1,Piemonte
2021-02-23,VDA,216,123,93,0,1,164,0,0,35,16,216,0,ITC,ITC2,2,Valle d'Aosta / Vallée d'Aoste
2021-04-19,BAS,2750,1230,1520,37,1,1404,3,1192,4,109,1499,1251,ITF,ITF5,17,Basilicata
2021-04-12,SIC,19081,9289,9792,423,29,14486,351,3653,21,118,11726,7355,ITG,ITG1,19,Sicilia
2021-02-28,PUG,5886,1786,4100,559,119,88,26,1484,194,3416,5700,186,ITF,ITF4,16,Puglia
2020-12-30,FVG,630,246,384,601,0,29,0,0,0,0,630,0,ITH,ITH4,6,Friuli-Venezia Giulia
2021-03-02,SAR,2865,1459,1406,1067,277,454,360,321,384,2,1712,1153,ITG,ITG2,20,Sardegna
2021-02-13,EMR,3617,1082,2535,2783,239,255,144,196,0,0,3019,598,ITH,ITH5,8,Emilia-Romagna
2021-03-26,PUG,11399,5320,6079,1605,503,1013,287,6396,255,1340,6760,4639,ITF,ITF4,16,Puglia
2021-03-03,MAR,6761,3094,3667,818,23,798,254,3133,952,783,5880,881,ITI,ITI3,11,Marche
2021-03-09,PAB,1194,543,651,29,6,96,22,922,72,47,1192,2,ITH,ITH1,4,Provincia Autonoma Bolzano / Bozen
2021-04-14,ABR,6133,2714,3419,334,19,4298,117,1303,3,59,4222,1911,ITF,ITF1,13,Abruzzo
2021-03-13,PIE,13032,4717,8315,1169,504,511,158,8551,1,2138,11589,1443,ITC,ITC1,1,Piemonte
2021-03-20,LIG,2316,995,1321,224,44,184,0,1855,9,0,1142,1174,ITC,ITC3,7,Liguria
2021-03-13,CAL,6657,2933,3724,425,44,1334,338,3766,65,685,5683,974,ITF,ITF6,18,Calabria
2021-04-06,TOS,22024,9697,12327,800,373,13572,136,5385,132,1626,18335,3689,ITI,ITI1,9,Toscana
2021-02-27,MAR,3374,1440,1934,186,9,163,161,2848,6,1,3165,209,ITI,ITI3,11,Marche
2021-02-02,PAT,907,240,667,507,33,11,189,167,0,0,190,717,ITH,ITH2,4,Provincia Autonoma Trento
2021-01-10,FVG,2941,919,2022,1745,6,945,245,0,0,0,2941,0,ITH,ITH4,6,Friuli-Venezia Giulia
2021-01-13,FVG,2651,834,1817,1822,9,590,230,0,0,0,2651,0,ITH,ITH4,6,Friuli-Venezia Giulia
2021-01-06,MAR,2181,792,1389,1738,40,256,147,0,0,0,2181,0,ITI,ITI3,11,Marche
2021-01-19,CAL,1109,488,621,853,8,172,76,0,0,0,1098,11,ITF,ITF6,18,Calabria
2021-04-01,PUG,13217,6042,7175,1237,300,2356,179,7946,165,1034,6883,6334,ITF,ITF4,16,Puglia
2021-02-17,LIG,2623,1165,1458,883,131,231,262,1115,0,1,2260,363,ITC,ITC3,7,Liguria
2021-03-06,LIG,3302,1841,1461,377,12,782,120,1537,473,1,2597,705,ITC,ITC3,7,Liguria
2021-02-23,MAR,3274,1400,1874,219,4,133,116,2794,8,0,3218,56,ITI,ITI3,11,Marche
2021-01-25,LIG,2717,888,1829,2208,128,62,317,0,0,2,471,2246,ITC,ITC3,7,Liguria
2021-04-12,LIG,11945,5278,6667,498,78,7121,106,4037,60,45,10123,1822,ITC,ITC3,7,Liguria
2021-01-30,LOM,12315,4567,7748,9906,2049,189,161,8,1,1,195,12120,ITC,ITC4,3,Lombardia
2021-02-12,LIG,1913,684,1229,866,119,104,393,430,0,1,895,1018,ITC,ITC3,7,Liguria
2021-03-31,MAR,7370,3084,4286,473,8,1911,153,4538,30,257,4352,3018,ITI,ITI3,11,Marche
2021-01-27,PAB,84,28,56,54,26,4,0,0,0,0,1,83,ITH,ITH1,4,Provincia Autonoma Bolzano / Bozen
2021-02-13,UMB,115,28,87,68,46,0,0,1,0,0,112,3,ITI,ITI2,10,Umbria
2021-01-11,PAT,729,221,508,522,49,5,153,0,0,0,729,0,ITH,ITH2,4,Provincia Autonoma Trento
2021-02-18,PIE,4784,2089,2695,2254,868,1035,624,0,1,2,4354,430,ITC,ITC1,1,Piemonte
2021-02-02,MAR,1193,397,796,804,17,279,93,0,0,0,73,1120,ITI,ITI3,11,Marche
2021-04-15,ABR,7373,3427,3946,200,12,5627,84,1391,7,52,5705,1668,ITF,ITF1,13,Abruzzo
2020-12-30,PIE,730,322,408,685,45,0,0,0,0,0,730,0,ITC,ITC1,1,Piemonte
2021-01-23,PAB,197,117,80,191,0,6,0,0,0,0,0,197,ITH,ITH1,4,Provincia Autonoma Bolzano / Bozen
2021-01-06,ABR,1830,664,1166,1546,119,32,133,0,0,0,1830,0,ITF,ITF1,13,Abruzzo
2021-01-04,LAZ,7478,2907,4571,7075,5,81,316,0,0,1,7478,0,ITI,ITI4,12,Lazio
2021-03-08,EMR,11986,4951,7035,2303,408,845,299,4304,1488,2339,9319,2667,ITH,ITH5,8,Emilia-Romagna
2021-02-09,CAM,4643,2202,2441,1148,178,1973,6,1338,0,0,4391,252,ITF,ITF3,15,Campania
2021-01-15,EMR,7703,2394,5309,5300,438,646,1318,0,0,1,7703,0,ITH,ITH5,8,Emilia-Romagna
2021-02-01,BAS,242,91,151,156,24,14,48,0,0,0,46,196,ITF,ITF5,17,Basilicata
2021-01-28,VEN,9206,2662,6544,6487,361,895,1451,7,0,5,175,9031,ITH,ITH3,5,Veneto
2021-03-30,EMR,23234,10275,12959,868,183,10115,162,10646,85,1175,18197,5037,ITH,ITH5,8,Emilia-Romagna
2021-03-20,LOM,32472,12133,20339,1984,1162,2210,524,18452,284,7856,22632,9840,ITC,ITC4,3,Lombardia
2021-03-17,SAR,6553,2849,3704,1077,452,1030,528,3334,4,128,4945,1608,ITG,ITG2,20,Sardegna
2021-01-29,EMR,10403,3494,6909,8104,393,848,1058,0,0,0,291,10112,ITH,ITH5,8,Emilia-Romagna
2021-04-07,TOS,35323,15155,20168,309,486,14964,98,19391,55,20,28152,7171,ITI,ITI1,9,Toscana
2021-01-04,SIC,8373,4172,4201,7595,20,752,6,0,0,0,8373,0,ITG,ITG1,19,Sicilia
2021-03-25,MOL,1806,730,1076,53,2,322,18,832,86,493,1309,497,ITF,ITF2,14,Molise
2021-01-23,UMB,277,100,177,276,1,0,0,0,0,0,2,275,ITI,ITI2,10,Umbria
2021-01-11,TOS,5094,1691,3403,4362,209,1,522,0,0,0,5094,0,ITI,ITI1,9,Toscana
2021-02-15,CAM,5469,2515,2954,987,220,771,94,3395,1,1,5296,173,ITF,ITF3,15,Campania
2021-04-06,PAB,2042,1024,1018,107,45,1691,130,62,4,3,1940,102,ITH,ITH1,4,Provincia Autonoma Bolzano / Bozen
2021-03-31,TOS,32316,12971,19345,278,84,4747,264,22846,398,3699,20229,12087,ITI,ITI1,9,Toscana
2021-03-20,SIC,18940,9091,9849,836,43,10872,414,5477,79,1219,13550,5390,ITG,ITG1,19,Sicilia
2021-03-17,VDA,430,185,245,35,2,90,15,240,41,7,270,160,ITC,ITC2,2,Valle d'Aosta / Vallée d'Aoste
2021-01-18,PAB,1769,686,1083,388,102,253,7,1019,0,0,1764,5,ITH,ITH1,4,Provincia Autonoma Bolzano / Bozen
2021-02-20,LIG,1334,636,698,159,28,436,122,589,0,0,1333,1,ITC,ITC3,7,Liguria
2020-12-28,LOM,107,47,60,105,2,0,0,0,0,0,107,0,ITC,ITC4,3,Lombardia
2021-03-07,UMB,845,180,665,17,68,14,25,45,0,676,838,7,ITI,ITI2,10,Umbria
2021-03-23,EMR,18664,8052,10612,1125,282,6183,195,9226,302,1351,11978,6686,ITH,ITH5,8,Emilia-Romagna
2021-01-13,UMB,450,139,311,379,28,1,42,0,0,0,450,0,ITI,ITI2,10,Umbria
2021-04-07,UMB,5519,2274,3245,482,35,1717,92,3168,6,19,3514,2005,ITI,ITI2,10,Umbria
2021-03-27,PAB,3047,1552,1495,322,32,1208,0,1436,3,46,1541,1506,ITH,ITH1,4,Provincia Autonoma Bolzano / Bozen
2021-04-18,LAZ,23423,10412,13011,443,23,16084,37,6803,7,26,15912,7511,ITI,ITI4,12,Lazio
2021-02-03,ABR,2061,717,1344,1541,47,355,118,0,0,0,419,1642,ITF,ITF1,13,Abruzzo
2021-02-09,VDA,251,84,167,78,9,21,14,75,1,53,68,183,ITC,ITC2,2,Valle d'Aosta / Vallée d'Aoste
2021-02-17,VDA,327,144,183,25,1,18,30,237,16,0,227,100,ITC,ITC2,2,Valle d'Aosta / Vallée d'Aoste
2021-03-04,EMR,16388,5337,11051,2609,477,742,239,6374,511,5436,13387,3001,ITH,ITH5,8,Emilia-Romagna
2021-01-24,VEN,4117,1219,2898,3755,17,118,222,1,0,4,28,4089,ITH,ITH3,5,Veneto
2021-03-13,UMB,1731,524,1207,120,122,58,49,152,78,1152,1486,245,ITI,ITI2,10,Umbria
2021-01-31,PUG,1808,825,983,1502,103,1,198,2,0,2,73,1735,ITF,ITF4,16,Puglia
2021-03-22,EMR,17433,7632,9801,1135,319,5360,160,9501,358,600,10571,6862,ITH,ITH5,8,Emilia-Romagna
2021-02-01,MOL,562,201,361,301,143,6,111,0,0,1,14,548,ITF,ITF2,14,Molise
2021-02-26,VDA,206,57,149,67,4,28,6,96,4,1,122,84,ITC,ITC2,2,Valle d'Aosta / Vallée d'Aoste
2021-03-26,PAT,3136,1222,1914,136,170,1239,108,890,40,553,2548,588,ITH,ITH2,4,Provincia Autonoma Trento
2021-03-25,LOM,42242,15758,26484,3408,1317,3999,1373,21102,199,10844,29854,12388,ITC,ITC4,3,Lombardia
2021-04-16,VEN,23697,10195,13502,716,153,12471,398,9830,6,123,11857,11840,ITH,ITH3,5,Veneto
2021-03-28,MOL,1589,741,848,155,15,234,0,1184,0,1,487,1102,ITF,ITF2,14,Molise
2021-02-22,MOL,265,129,136,56,31,108,62,8,0,0,250,15,ITF,ITF2,14,Molise
2021-02-12,MAR,1583,618,965,815,11,669,88,0,0,0,1431,152,ITI,ITI3,11,Marche
2021-03-30,LOM,39141,15341,23800,2647,1358,4695,1144,22241,154,6902,24442,14699,ITC,ITC4,3,Lombardia
2020-12-31,FVG,1053,384,669,1011,0,42,0,0,0,0,1053,0,ITH,ITH4,6,Friuli-Venezia Giulia
2021-02-02,CAL,2289,1112,1177,1863,4,347,75,0,0,0,177,2112,ITF,ITF6,18,Calabria
2021-01-09,TOS,4485,1596,2889,3780,143,1,560,1,0,0,4485,0,ITI,ITI1,9,Toscana
2021-04-04,PUG,5898,2938,2960,43,4,5512,0,282,19,38,5891,7,ITF,ITF4,16,Puglia
2021-04-10,EMR,20710,9194,11516,507,157,10901,87,8853,16,189,16606,4104,ITH,ITH5,8,Emilia-Romagna
2021-03-21,LAZ,17804,6817,10987,1239,27,4694,111,8196,101,3436,12782,5022,ITI,ITI4,12,Lazio
2021-03-24,EMR,20926,9232,11694,1214,270,6848,121,10544,234,1695,13571,7355,ITH,ITH5,8,Emilia-Romagna
2021-04-11,SIC,15500,7626,7874,220,25,11726,178,3245,9,97,8470,7030,ITG,ITG1,19,Sicilia
2021-01-18,UMB,613,219,394,347,114,8,144,0,0,0,529,84,ITI,ITI2,10,Umbria
2021-03-06,VDA,22,4,18,13,0,0,5,4,0,0,22,0,ITC,ITC2,2,Valle d'Aosta / Vallée d'Aoste
2021-01-15,PIE,8967,2954,6013,5499,1861,61,1546,0,0,0,8967,0,ITC,ITC1,1,Piemonte
2021-03-22,VEN,18071,8124,9947,1195,126,6693,549,6706,309,2493,13027,5044,ITH,ITH3,5,Veneto
2021-01-21,LIG,1102,385,717,584,69,116,332,1,0,0,672,430,ITC,ITC3,7,Liguria
2021-02-05,CAM,7261,3463,3798,3447,995,2502,308,9,0,0,2133,5128,ITF,ITF3,15,Campania
2021-03-23,VEN,22027,10144,11883,1114,207,10103,671,6682,383,2867,17385,4642,ITH,ITH3,5,Veneto
2021-02-07,FVG,1561,483,1078,866,693,0,2,0,0,0,386,1175,ITH,ITH4,6,Friuli-Venezia Giulia
2021-01-26,LOM,8335,2709,5626,6650,1270,170,223,22,0,0,334,8001,ITC,ITC4,3,Lombardia
2021-01-19,ABR,111,55,56,27,1,33,50,0,0,0,91,20,ITF,ITF1,13,Abruzzo
2021-03-24,VEN,21921,9420,12501,1190,241,5957,806,10423,205,3099,15115,6806,ITH,ITH3,5,Veneto
2021-01-31,FVG,2715,836,1879,1693,2,1002,18,0,0,0,385,2330,ITH,ITH4,6,Friuli-Venezia Giulia
2021-02-08,MAR,833,258,575,408,21,142,262,0,0,0,371,462,ITI,ITI3,11,Marche
2021-03-17,FVG,3221,1260,1961,429,219,119,199,2246,3,6,728,2493,ITH,ITH4,6,Friuli-Venezia Giulia
2021-01-15,VDA,218,82,136,116,32,36,28,6,0,0,218,0,ITC,ITC2,2,Valle d'Aosta / Vallée d'Aoste
2021-02-01,LAZ,5669,2173,3496,4784,189,130,559,7,0,0,353,5316,ITI,ITI4,12,Lazio
2021-03-17,LIG,5521,2356,3165,781,112,289,76,4254,2,7,2463,3058,ITC,ITC3,7,Liguria
2021-04-03,ABR,5073,2213,2860,174,1,2378,27,2401,8,84,3479,1594,ITF,ITF1,13,Abruzzo
2021-01-17,PAB,2328,1044,1284,56,38,212,37,1985,0,0,2317,11,ITH,ITH1,4,Provincia Autonoma Bolzano / Bozen
2021-03-19,PIE,10965,4491,6474,1092,472,524,429,8177,0,271,4407,6558,ITC,ITC1,1,Piemonte
2021-03-10,FVG,3362,1494,1868,306,244,128,207,1973,309,195,1570,1792,ITH,ITH4,6,Friuli-Venezia Giulia
2021-03-27,FVG,4979,2557,2422,60,30,2786,1,1989,15,98,3568,1411,ITH,ITH4,6,Friuli-Venezia Giulia
2021-04-09,LOM,51061,21817,29244,2223,1436,9884,1215,33197,85,3021,35290,15771,ITC,ITC4,3,Lombardia
2021-03-03,SIC,14705,6545,8160,2408,130,2202,507,4295,1330,3833,11620,3085,ITG,ITG1,19,Sicilia
2021-02-04,UMB,733,226,507,693,19,1,20,0,0,0,25,708,ITI,ITI2,10,Umbria
2021-03-02,UMB,3638,1345,2293,318,223,51,55,1302,243,1446,3634,4,ITI,ITI2,10,Umbria
2021-02-04,PAB,1927,587,1340,650,505,125,433,214,0,0,8,1919,ITH,ITH1,4,Provincia Autonoma Bolzano / Bozen
2021-01-30,MOL,461,158,303,189,52,40,180,0,0,0,12,449,ITF,ITF2,14,Molise
2021-03-28,PIE,16034,6892,9142,926,773,2795,34,8920,106,2480,8426,7608,ITC,ITC1,1,Piemonte
2021-04-08,VEN,31764,14069,17695,849,100,19558,579,10206,31,441,23935,7829,ITH,ITH3,5,Veneto
2021-03-11,LAZ,23668,10522,13146,4849,124,3030,440,9262,1526,4437,17444,6224,ITI,ITI4,12,Lazio
2021-03-28,CAM,15549,7498,8051,79,155,9391,18,5103,124,679,13926,1623,ITF,ITF3,15,Campania
2021-02-16,CAL,1534,643,891,659,11,506,240,118,0,0,1255,279,ITF,ITF6,18,Calabria
2021-03-04,MOL,850,417,433,252,18,6,69,469,36,0,526,324,ITF,ITF2,14,Molise
2021-01-05,ABR,1614,604,1010,1604,0,10,0,0,0,0,1614,0,ITF,ITF1,13,Abruzzo
2020-12-31,PIE,3909,1334,2575,3415,354,6,134,0,0,0,3909,0,ITC,ITC1,1,Piemonte
2021-02-24,CAM,11767,4146,7621,845,192,436,145,5960,0,4189,11079,688,ITF,ITF3,15,Campania
2021-02-04,LIG,2814,985,1829,1866,376,92,471,0,1,8,179,2635,ITC,ITC3,7,Liguria
2021-03-24,VDA,512,230,282,8,3,131,0,367,2,1,257,255,ITC,ITC2,2,Valle d'Aosta / Vallée d'Aoste
2021-04-11,PAB,2719,1291,1428,46,6,2509,2,83,10,63,2541,178,ITH,ITH1,4,Provincia Autonoma Bolzano / Bozen
2021-01-16,BAS,721,304,417,466,17,75,161,0,0,2,721,0,ITF,ITF5,17,Basilicata
2021-01-10,VEN,5031,1670,3361,3855,167,541,462,3,2,1,5031,0,ITH,ITH3,5,Veneto
2021-03-14,PAT,107,65,42,102,0,0,0,0,0,5,20,87,ITH,ITH2,4,Provincia Autonoma Trento
2021-04-12,TOS,2562,1170,1392,168,262,1658,196,268,4,6,1912,650,ITI,ITI1,9,Toscana
2021-04-05,SIC,8191,4033,4158,232,6,4792,176,2925,4,56,6750,1441,ITG,ITG1,19,Sicilia
2021-01-23,LIG,809,295,514,633,94,38,43,0,0,1,153,656,ITC,ITC3,7,Liguria
2021-03-17,UMB,3330,1313,2017,1430,53,9,131,1683,8,16,1858,1472,ITI,ITI2,10,Umbria
2021-04-06,LIG,12472,5543,6929,538,111,7007,204,3990,72,550,10367,2105,ITC,ITC3,7,Liguria
2021-02-08,ABR,1201,398,803,710,122,105,264,0,0,0,491,710,ITF,ITF1,13,Abruzzo
2021-02-15,LIG,2259,838,1421,1086,185,82,241,662,1,2,1862,397,ITC,ITC3,7,Liguria
2021-03-12,BAS,1896,975,921,266,61,48,37,985,241,258,798,1098,ITF,ITF5,17,Basilicata
2021-01-28,PAB,868,307,561,584,186,27,69,0,2,0,10,858,ITH,ITH1,4,Provincia Autonoma Bolzano / Bozen
2021-03-22,PAB,1133,514,619,2,0,929,0,192,10,0,1129,4,ITH,ITH1,4,Provincia Autonoma Bolzano / Bozen
2021-01-19,BAS,199,84,115,78,48,29,44,0,0,0,199,0,ITF,ITF5,17,Basilicata
2021-02-12,EMR,5314,1676,3638,3395,458,451,704,306,0,0,3912,1402,ITH,ITH5,8,Emilia-Romagna
2021-02-25,MAR,3563,1447,2116,432,6,207,423,2491,3,1,3384,179,ITI,ITI3,11,Marche
2021-04-06,CAM,24345,11410,12935,302,107,16788,123,5365,105,1555,19830,4515,ITF,ITF3,15,Campania
2021-04-06,PIE,20156,8768,11388,647,313,7913,260,9612,92,1319,14992,5164,ITC,ITC1,1,Piemonte
2021-02-28,LIG,1060,581,479,12,1,570,3,474,0,0,1051,9,ITC,ITC3,7,Liguria
2021-01-25,TOS,5126,1896,3230,4160,54,2,909,1,0,0,249,4877,ITI,ITI1,9,Toscana
2021-02-28,CAM,10411,3206,7205,496,113,2047,22,2237,0,5496,8511,1900,ITF,ITF3,15,Campania
2021-01-29,LOM,13438,4114,9324,10487,2256,113,573,9,0,0,654,12784,ITC,ITC4,3,Lombardia
2021-03-14,FVG,1396,548,848,0,1,17,0,247,334,797,1144,252,ITH,ITH4,6,Friuli-Venezia Giulia
2020-12-30,LIG,12,5,7,12,0,0,0,0,0,0,12,0,ITC,ITC3,7,Liguria
2021-04-09,EMR,25211,11431,13780,1353,173,12460,157,10579,55,434,19626,5585,ITH,ITH5,8,Emilia-Romagna
2021-02-07,CAM,2929,1382,1547,706,189,1519,225,290,0,0,2158,771,ITF,ITF3,15,Campania
2021-02-27,PAB,2457,759,1698,202,86,43,8,882,3,1233,2447,10,ITH,ITH1,4,Provincia Autonoma Bolzano / Bozen
2021-04-01,VDA,770,391,379,1,0,573,0,196,0,0,759,11,ITC,ITC2,2,Valle d'Aosta / Vallée d'Aoste
2021-02-10,FVG,1352,496,856,745,487,0,119,0,0,1,1266,86,ITH,ITH4,6,Friuli-Venezia Giulia
2021-01-25,PAB,487,183,304,401,68,14,0,1,2,1,3,484,ITH,ITH1,4,Provincia Autonoma Bolzano / Bozen
2021-04-11,TOS,3557,1639,1918,60,33,2029,98,1333,0,4,3404,153,ITI,ITI1,9,Toscana
2021-01-05,MAR,1562,586,976,1436,0,126,0,0,0,0,1562,0,ITI,ITI3,11,Marche
2021-01-27,MAR,2120,780,1340,1754,7,219,140,0,0,0,122,1998,ITI,ITI3,11,Marche
2021-02-09,LIG,1904,683,1221,1087,197,143,455,0,0,22,256,1648,ITC,ITC3,7,Liguria
2021-04-08,UMB,5674,2393,3281,343,11,2254,163,2886,5,12,3986,1688,ITI,ITI2,10,Umbria
2021-02-21,CAL,608,286,322,36,28,136,47,331,30,0,531,77,ITF,ITF6,18,Calabria
2020-12-31,CAM,1490,811,679,1273,150,66,1,0,0,0,1490,0,ITF,ITF3,15,Campania
2021-04-07,PAB,1777,802,975,128,75,1055,57,452,8,2,1238,539,ITH,ITH1,4,Provincia Autonoma Bolzano / Bozen
2021-03-22,LIG,7367,3277,4090,578,115,1613,82,3824,281,874,4524,2843,ITC,ITC3,7,Liguria
2021-04-03,MAR,7586,3209,4377,321,3,3989,55,2923,2,293,6915,671,ITI,ITI3,11,Marche
2021-03-20,CAM,13894,6433,7461,295,35,3812,35,6510,324,2883,10155,3739,ITF,ITF3,15,Campania
2021-02-25,SIC,10161,5277,4884,1771,49,1656,507,3981,1525,672,8981,1180,ITG,ITG1,19,Sicilia
2021-01-04,BAS,607,271,336,550,45,10,0,0,0,2,607,0,ITF,ITF5,17,Basilicata
2021-04-08,FVG,7051,2958,4093,242,126,3474,231,2941,4,33,5137,1914,ITH,ITH4,6,Friuli-Venezia Giulia
2021-01-28,SAR,2968,1044,1924,2554,327,76,0,0,11,0,69,2899,ITG,ITG2,20,Sardegna
2021-01-07,LAZ,7743,2901,4842,6898,175,104,566,0,0,0,7743,0,ITI,ITI4,12,Lazio
2021-01-26,FVG,1974,647,1327,1441,0,152,381,0,0,0,214,1760,ITH,ITH4,6,Friuli-Venezia Giulia
2021-04-15,EMR,28276,13466,14810,912,113,21461,111,5613,20,46,18893,9383,ITH,ITH5,8,Emilia-Romagna
2021-01-10,SAR,2183,750,1433,1632,228,323,0,0,0,0,2183,0,ITG,ITG2,20,Sardegna
2021-04-01,BAS,2826,1145,1681,79,0,273,0,2175,11,288,2112,714,ITF,ITF5,17,Basilicata
2021-02-01,SIC,6078,2684,3394,4168,214,1378,318,0,0,0,304,5774,ITG,ITG1,19,Sicilia
2020-12-27,VDA,20,9,11,20,0,0,0,0,0,0,20,0,ITC,ITC2,2,Valle d'Aosta / Vallée d'Aoste
2021-03-22,UMB,3558,1653,1905,163,120,201,0,2828,99,147,2312,1246,ITI,ITI2,10,Umbria
2021-02-16,PUG,3379,1452,1927,2148,732,65,412,4,16,2,2734,645,ITF,ITF4,16,Puglia
2021-02-09,PAB,317,126,191,64,16,6,2,227,0,2,1,316,ITH,ITH1,4,Provincia Autonoma Bolzano / Bozen
2021-03-09,TOS,10587,4089,6498,4806,905,1179,180,3292,214,11,5035,5552,ITI,ITI1,9,Toscana
2021-01-10,PAT,84,19,65,54,18,0,12,0,0,0,84,0,ITH,ITH2,4,Provincia Autonoma Trento
2021-03-14,SAR,606,376,230,34,1,235,0,251,73,12,606,0,ITG,ITG2,20,Sardegna
2021-01-14,MOL,646,239,407,418,82,31,115,0,0,0,646,0,ITF,ITF2,14,Molise
2021-02-20,LAZ,8852,4108,4744,1942,111,396,298,4773,1310,22,8409,443,ITI,ITI4,12,Lazio
2021-02-27,TOS,1944,723,1221,1352,311,3,132,1,126,19,1042,902,ITI,ITI1,9,Toscana
2021-03-17,PAB,580,213,367,11,6,35,46,482,0,0,579,1,ITH,ITH1,4,Provincia Autonoma Bolzano / Bozen
2021-01-28,UMB,1240,392,848,891,4,0,345,0,0,0,19,1221,ITI,ITI2,10,Umbria
2021-03-01,EMR,10050,3569,6481,1824,280,363,431,5588,311,1253,7805,2245,ITH,ITH5,8,Emilia-Romagna
2020-12-27,MAR,200,97,103,184,4,8,4,0,0,0,200,0,ITI,ITI3,11,Marche
2021-01-18,ABR,122,48,74,106,0,14,2,0,0,0,46,76,ITF,ITF1,13,Abruzzo
2021-01-31,PAT,75,15,60,55,13,1,6,0,0,0,1,74,ITH,ITH2,4,Provincia Autonoma Trento
2021-02-07,PIE,3087,974,2113,1648,643,19,777,0,0,0,445,2642,ITC,ITC1,1,Piemonte
2021-04-12,PIE,22392,10097,12295,605,205,14068,235,7211,8,60,19426,2966,ITC,ITC1,1,Piemonte
2021-02-21,CAM,5833,2239,3594,780,44,609,22,3870,0,508,5608,225,ITF,ITF3,15,Campania
2021-01-17,CAM,1155,551,604,718,54,232,151,0,0,0,702,453,ITF,ITF3,15,Campania
2021-04-01,ABR,5530,2450,3080,274,8,2095,57,2908,35,153,3441,2089,ITF,ITF1,13,Abruzzo
2021-04-08,SAR,12949,5680,7269,714,123,7006,61,4724,34,287,8081,4868,ITG,ITG2,20,Sardegna
2021-01-02,TOS,3498,1097,2401,2682,15,0,801,0,0,0,3498,0,ITI,ITI1,9,Toscana
2021-04-05,LAZ,19693,8960,10733,538,34,11522,28,7498,10,63,13549,6144,ITI,ITI4,12,Lazio
2021-03-19,CAM,11030,4868,6162,392,67,1215,21,8437,45,853,7161,3869,ITF,ITF3,15,Campania
2021-03-14,PUG,3262,1407,1855,944,71,144,84,975,43,1001,2496,766,ITF,ITF4,16,Puglia
2021-03-18,MAR,3445,1514,1931,326,6,258,123,2653,76,3,216,3229,ITI,ITI3,11,Marche
2021-04-14,SIC,20659,9934,10725,599,36,15384,376,4145,19,100,11831,8828,ITG,ITG1,19,Sicilia
2021-01-08,PIE,5529,1761,3768,4078,971,58,422,0,0,0,5529,0,ITC,ITC1,1,Piemonte
2021-03-31,UMB,3873,1714,2159,177,21,531,160,2959,2,23,2211,1662,ITI,ITI2,10,Umbria
2021-02-08,VDA,223,83,140,28,17,86,3,64,0,25,25,198,ITC,ITC2,2,Valle d'Aosta / Vallée d'Aoste
2021-01-17,LIG,861,300,561,516,16,66,262,0,0,1,861,0,ITC,ITC3,7,Liguria
2021-01-10,UMB,1056,275,781,740,3,4,309,0,0,0,1056,0,ITI,ITI2,10,Umbria
2021-02-24,LOM,14653,5919,8734,3585,1448,308,1786,6320,1182,24,13730,923,ITC,ITC4,3,Lombardia
2021-02-02,VDA,271,70,201,225,34,9,3,0,0,0,2,269,ITC,ITC2,2,Valle d'Aosta / Vallée d'Aoste
2021-01-15,ABR,379,149,230,223,6,115,35,0,0,0,379,0,ITF,ITF1,13,Abruzzo
2021-02-10,PAT,850,290,560,310,7,2,51,480,0,0,509,341,ITH,ITH2,4,Provincia Autonoma Trento
2021-02-07,LIG,407,153,254,191,12,17,187,0,0,0,2,405,ITC,ITC3,7,Liguria
2021-01-21,CAM,2093,1116,977,1379,153,486,75,0,0,0,677,1416,ITF,ITF3,15,Campania
2021-03-29,CAM,18952,9136,9816,362,49,12016,128,5040,153,1204,17408,1544,ITF,ITF3,15,Campania
2021-01-03,LAZ,5250,1972,3278,5125,18,42,65,0,0,0,5250,0,ITI,ITI4,12,Lazio
2021-02-18,EMR,7039,2892,4147,894,136,396,236,5377,0,0,6456,583,ITH,ITH5,8,Emilia-Romagna
2021-01-08,SAR,3257,1184,2073,2929,230,98,0,0,0,0,3257,0,ITG,ITG2,20,Sardegna
2021-04-02,PAT,2741,1132,1609,148,65,1509,44,668,15,292,2096,645,ITH,ITH2,4,Provincia Autonoma Trento
2021-04-11,PIE,20801,9308,11493,399,153,13048,68,6875,4,254,18640,2161,ITC,ITC1,1,Piemonte
2021-01-12,PAT,504,158,346,418,25,0,61,0,0,0,504,0,ITH,ITH2,4,Provincia Autonoma Trento
2021-04-02,PUG,12234,5624,6610,866,175,2901,254,7306,106,626,7719,4515,ITF,ITF4,16,Puglia
2021-01-26,SIC,9528,4685,4843,8391,72,811,254,0,0,0,265,9263,ITG,ITG1,19,Sicilia
2021-03-11,LIG,6213,2987,3226,1144,109,530,261,3663,504,2,4211,2002,ITC,ITC3,7,Liguria
2021-01-10,MAR,1737,699,1038,1462,0,275,0,0,0,0,1737,0,ITI,ITI3,11,Marche
2021-04-09,SIC,20638,10075,10563,740,110,14729,358,4371,45,285,11471,9167,ITG,ITG1,19,Sicilia
2021-03-29,FVG,6839,2991,3848,237,182,3514,143,2406,46,311,5259,1580,ITH,ITH4,6,Friuli-Venezia Giulia
2021-02-18,SAR,1877,732,1145,1073,301,61,298,1,33,110,1813,64,ITG,ITG2,20,Sardegna
2021-01-12,FVG,2259,712,1547,1528,19,351,361,0,0,0,2259,0,ITH,ITH4,6,Friuli-Venezia Giulia
2021-03-31,EMR,24901,10848,14053,1169,185,9796,119,12258,88,1286,19487,5414,ITH,ITH5,8,Emilia-Romagna
2021-03-29,CAL,5629,2381,3248,206,6,2560,134,1111,32,1580,3876,1753,ITF,ITF6,18,Calabria
2021-04-05,LIG,3970,1748,2222,190,22,1528,9,2210,1,10,2321,1649,ITC,ITC3,7,Liguria
2021-03-18,PIE,11737,4797,6940,1463,677,366,342,8871,0,18,4027,7710,ITC,ITC1,1,Piemonte
2021-01-21,PIE,6880,2314,4566,4707,826,29,1318,0,0,0,3385,3495,ITC,ITC1,1,Piemonte
2021-01-01,PAT,213,50,163,114,11,0,88,0,0,0,213,0,ITH,ITH2,4,Provincia Autonoma Trento
2021-03-03,PAB,1166,391,775,12,5,9,6,345,51,738,1153,13,ITH,ITH1,4,Provincia Autonoma Bolzano / Bozen
2021-01-03,SIC,4694,2454,2240,4362,0,332,0,0,0,0,4694,0,ITG,ITG1,19,Sicilia
2021-03-24,TOS,19572,7928,11644,222,326,4440,195,13405,211,773,10150,9422,ITI,ITI1,9,Toscana
2021-02-27,UMB,1658,354,1304,14,11,0,13,0,60,1560,1642,16,ITI,ITI2,10,Umbria
2021-03-09,CAL,5824,3032,2792,803,23,1918,419,1769,874,18,4847,977,ITF,ITF6,18,Calabria
2021-04-06,UMB,5233,2138,3095,598,43,1152,79,3332,1,28,2885,2348,ITI,ITI2,10,Umbria
2021-03-09,FVG,3863,1590,2273,657,420,102,195,2005,60,424,1110,2753,ITH,ITH4,6,Friuli-Venezia Giulia
2021-04-01,MOL,1437,654,783,27,8,628,21,715,18,20,712,725,ITF,ITF2,14,Molise
2021-03-14,BAS,1008,477,531,41,110,13,8,516,71,249,539,469,ITF,ITF5,17,Basilicata
2021-03-23,TOS,9047,4077,4970,309,302,4189,328,3442,139,338,6806,2241,ITI,ITI1,9,Toscana
2021-01-12,PUG,4206,1767,2439,3632,339,11,218,1,0,5,4206,0,ITF,ITF4,16,Puglia
2021-04-16,LAZ,33268,15235,18033,680,107,23414,335,8615,32,85,21589,11679,ITI,ITI4,12,Lazio
2021-02-06,LAZ,5171,2075,3096,3279,207,464,680,541,0,0,803,4368,ITI,ITI4,12,Lazio
2021-02-16,LOM,9534,3084,6450,5847,2100,159,1393,8,8,19,9083,451,ITC,ITC4,3,Lombardia
2021-01-04,LIG,2615,854,1761,2197,81,158,176,0,0,3,2615,0,ITC,ITC3,7,Liguria
2021-01-09,LOM,12404,4570,7834,9524,2053,624,196,6,1,0,12404,0,ITC,ITC4,3,Lombardia
2021-02-11,PAT,1132,365,767,332,3,11,48,738,0,0,796,336,ITH,ITH2,4,Provincia Autonoma Trento
2021-02-05,TOS,5748,2244,3504,4121,1180,4,442,1,0,0,1924,3824,ITI,ITI1,9,Toscana
2020-12-31,UMB,322,127,195,310,0,12,0,0,0,0,322,0,ITI,ITI2,10,Umbria
2021-02-26,CAM,13327,4228,9099,951,125,798,220,3403,1,7829,11992,1335,ITF,ITF3,15,Campania
2021-03-28,FVG,4806,2271,2535,13,13,2938,0,425,111,1306,4666,140,ITH,ITH4,6,Friuli-Venezia Giulia
2021-02-27,SAR,1920,647,1273,1059,291,88,306,176,0,0,1365,555,ITG,ITG2,20,Sardegna
2021-01-07,LOM,11712,3622,8090,8962,1718,212,786,32,1,1,11712,0,ITC,ITC4,3,Lombardia
2021-01-16,MOL,420,166,254,270,14,9,127,0,0,0,420,0,ITF,ITF2,14,Molise
2021-02-05,LAZ,6959,2747,4212,5095,373,293,995,203,0,0,1145,5814,ITI,ITI4,12,Lazio
2021-01-08,PAB,1514,476,1038,787,167,291,168,101,0,0,1514,0,ITH,ITH1,4,Provincia Autonoma Bolzano / Bozen
2021-04-03,MOL,1764,847,917,28,0,1441,0,266,3,26,1731,33,ITF,ITF2,14,Molise
2021-02-02,TOS,3742,1475,2267,3021,283,4,422,6,6,0,195,3547,ITI,ITI1,9,Toscana
2021-03-23,VDA,375,149,226,13,2,70,7,276,0,7,242,133,ITC,ITC2,2,Valle d'Aosta / Vallée d'Aoste
2021-02-19,PAB,1969,450,1519,121,139,111,80,7,0,1511,1958,11,ITH,ITH1,4,Provincia Autonoma Bolzano / Bozen
2021-02-23,UMB,1693,658,1035,1187,95,0,17,394,0,0,1651,42,ITI,ITI2,10,Umbria
2021-03-17,BAS,1448,606,842,22,11,18,0,1390,5,2,27,1421,ITF,ITF5,17,Basilicata
2021-02-18,VEN,5792,2444,3348,956,75,288,667,3798,0,8,5728,64,ITH,ITH3,5,Veneto
2021-03-09,PAT,1568,584,984,98,42,14,31,1092,92,199,934,634,ITH,ITH2,4,Provincia Autonoma Trento
2021-02-26,PIE,12239,4912,7327,813,377,1067,487,6598,1,2896,11502,737,ITC,ITC1,1,Piemonte
2021-02-06,SIC,5068,2227,2841,2535,252,1689,592,0,0,0,1488,3580,ITG,ITG1,19,Sicilia
2021-02-18,PAB,1646,401,1245,23,44,270,20,4,0,1285,1642,4,ITH,ITH1,4,Provincia Autonoma Bolzano / Bozen
2021-02-11,TOS,5383,2021,3362,2809,284,1934,323,12,10,11,5141,242,ITI,ITI1,9,Toscana
2021-01-25,PUG,3820,1677,2143,3471,165,12,169,2,0,1,422,3398,ITF,ITF4,16,Puglia
2021-04-10,TOS,11530,5253,6277,258,188,3027,117,7928,9,3,10791,739,ITI,ITI1,9,Toscana
2021-02-07,MAR,1871,735,1136,1156,5,664,46,0,0,0,344,1527,ITI,ITI3,11,Marche
2021-03-03,PIE,12114,4640,7474,1103,437,592,257,7057,3,2665,11295,819,ITC,ITC1,1,Piemonte
2021-01-09,EMR,9935,3438,6497,7860,555,630,889,1,0,0,9935,0,ITH,ITH5,8,Emilia-Romagna
2021-02-27,ABR,2809,1337,1472,253,23,162,123,732,642,874,2543,266,ITF,ITF1,13,Abruzzo
2021-04-12,PUG,28201,13264,14937,501,123,22651,23,4700,46,157,25466,2735,ITF,ITF4,16,Puglia
2021-01-19,SIC,1271,521,750,521,59,453,238,0,0,0,1093,178,ITG,ITG1,19,Sicilia
2021-04-05,MOL,370,181,189,1,0,273,0,96,0,0,271,99,ITF,ITF2,14,Molise
2021-04-08,MAR,7523,3285,4238,273,8,5166,37,1317,7,715,7192,331,ITI,ITI3,11,Marche
2021-02-17,EMR,6537,2764,3773,803,206,1072,404,4052,0,0,5764,773,ITH,ITH5,8,Emilia-Romagna
2021-02-24,ABR,3304,1440,1864,391,17,324,247,1968,226,131,3128,176,ITF,ITF1,13,Abruzzo
2021-02-16,EMR,5734,2431,3303,742,241,668,437,3644,2,0,5204,530,ITH,ITH5,8,Emilia-Romagna
2021-02-25,PAB,1498,549,949,22,5,335,0,731,0,405,1497,1,ITH,ITH1,4,Provincia Autonoma Bolzano / Bozen
2021-03-13,LAZ,21344,8379,12965,5143,109,2385,330,8918,720,3739,15451,5893,ITI,ITI4,12,Lazio
2021-02-03,LAZ,6309,2359,3950,4621,335,229,1078,46,0,0,910,5399,ITI,ITI4,12,Lazio
2021-03-05,PIE,15259,5956,9303,2539,1099,923,655,7672,1,2370,11443,3816,ITC,ITC1,1,Piemonte
2021-03-23,MAR,5818,2538,3280,259,9,360,130,4588,144,328,2271,3547,ITI,ITI3,11,Marche
2021-04-07,VDA,904,472,432,15,0,509,0,379,0,1,676,228,ITC,ITC2,2,Valle d'Aosta / Vallée d'Aoste
2021-03-24,LAZ,25626,11153,14473,3773,92,8413,107,9402,240,3599,19515,6111,ITI,ITI4,12,Lazio
2021-02-03,SIC,6104,2858,3246,3359,152,1969,624,0,0,0,756,5348,ITG,ITG1,19,Sicilia
2021-03-23,LAZ,23148,10007,13141,2491,98,6806,181,9178,538,3856,16852,6296,ITI,ITI4,12,Lazio
2021-02-23,PIE,9230,3711,5519,2298,821,565,389,4105,0,1052,8650,580,ITC,ITC1,1,Piemonte
2021-03-21,UMB,665,330,335,31,14,522,0,0,34,64,665,0,ITI,ITI2,10,Umbria
2021-04-04,SAR,1,0,1,0,0,0,0,1,0,0,0,1,ITG,ITG2,20,Sardegna
2021-03-29,LOM,39828,15420,24408,2975,1617,4344,434,21689,168,8601,25105,14723,ITC,ITC4,3,Lombardia
2021-03-24,MAR,7036,2982,4054,484,20,961,187,4728,64,592,3367,3669,ITI,ITI3,11,Marche
2021-01-01,PUG,146,60,86,145,1,0,0,0,0,0,146,0,ITF,ITF4,16,Puglia
2021-02-27,VEN,8987,2691,6296,2314,39,468,64,1963,11,4128,8137,850,ITH,ITH3,5,Veneto
2021-02-20,LOM,9427,3894,5533,4295,980,140,225,2919,864,4,9131,296,ITC,ITC4,3,Lombardia
2021-03-12,CAL,5093,2438,2655,468,26,1300,217,1963,333,786,4050,1043,ITF,ITF6,18,Calabria
2021-01-29,ABR,1386,449,937,1290,2,94,0,0,0,0,74,1312,ITF,ITF1,13,Abruzzo
2020-12-31,LIG,989,354,635,751,17,38,155,28,0,0,989,0,ITC,ITC3,7,Liguria
2021-03-03,UMB,4436,1772,2664,720,236,53,86,1518,290,1533,3724,712,ITI,ITI2,10,Umbria
2021-01-20,MAR,398,99,299,146,15,47,190,0,0,0,386,12,ITI,ITI3,11,Marche
2021-04-11,ABR,5073,2461,2612,15,3,4263,7,777,3,5,4590,483,ITF,ITF1,13,Abruzzo
2021-03-06,MOL,1728,807,921,156,15,10,0,1395,152,0,1569,159,ITF,ITF2,14,Molise
2021-03-22,VDA,557,204,353,36,4,137,18,335,10,17,331,226,ITC,ITC2,2,Valle d'Aosta / Vallée d'Aoste
2021-02-12,BAS,775,332,443,288,138,63,90,190,6,0,744,31,ITF,ITF5,17,Basilicata
2021-03-04,PUG,15019,5857,9162,1530,405,512,322,4730,1237,6283,13641,1378,ITF,ITF4,16,Puglia
2021-01-19,LAZ,4449,1729,2720,2968,222,399,424,436,0,0,3995,454,ITI,ITI4,12,Lazio
2021-02-18,UMB,1495,582,913,324,14,2,170,985,0,0,1029,466,ITI,ITI2,10,Umbria
2021-03-03,MOL,672,316,356,63,1,4,48,384,45,127,590,82,ITF,ITF2,14,Molise
2021-03-15,LIG,7298,3072,4226,819,171,1245,106,3774,221,962,4596,2702,ITC,ITC3,7,Liguria
2021-02-10,VDA,248,77,171,51,8,16,26,128,1,18,141,107,ITC,ITC2,2,Valle d'Aosta / Vallée d'Aoste
2021-02-21,LIG,869,491,378,183,21,296,102,267,0,0,865,4,ITC,ITC3,7,Liguria
2021-01-25,ABR,1604,633,971,1584,0,20,0,0,0,0,20,1584,ITF,ITF1,13,Abruzzo
2021-04-11,UMB,3097,1500,1597,30,1,2889,2,136,35,4,3048,49,ITI,ITI2,10,Umbria
2021-02-20,CAL,1358,735,623,438,23,388,55,433,19,2,1043,315,ITF,ITF6,18,Calabria
2021-01-08,EMR,10826,3566,7260,8463,423,852,1088,0,0,0,10826,0,ITH,ITH5,8,Emilia-Romagna
2021-02-24,EMR,9295,3544,5751,651,88,492,228,7773,0,63,8419,876,ITH,ITH5,8,Emilia-Romagna
2021-01-06,MOL,689,260,429,456,26,36,171,0,0,0,689,0,ITF,ITF2,14,Molise
2021-04-13,SIC,20034,9781,10253,665,51,15136,269,3753,33,127,11283,8751,ITG,ITG1,19,Sicilia
2021-04-11,LOM,31382,13610,17772,965,285,5359,412,22385,772,1204,24036,7346,ITC,ITC4,3,Lombardia
2021-04-16,SIC,28691,14408,14283,744,95,22946,605,4173,21,107,20355,8336,ITG,ITG1,19,Sicilia
2021-02-17,ABR,2077,952,1125,512,27,215,394,718,210,1,1794,283,ITF,ITF1,13,Abruzzo
2021-01-25,PIE,6213,1938,4275,4786,839,26,562,0,0,0,983,5230,ITC,ITC1,1,Piemonte
2021-04-12,PAT,3025,1379,1646,135,27,1736,27,724,12,364,2540,485,ITH,ITH2,4,Provincia Autonoma Trento
2021-03-18,CAM,12163,5376,6787,460,76,1096,34,9962,76,459,5975,6188,ITF,ITF3,15,Campania
2021-01-17,VDA,131,56,75,49,2,1,20,59,0,0,131,0,ITC,ITC2,2,Valle d'Aosta / Vallée d'Aoste
2021-03-05,CAM,16474,6346,10128,1682,224,2364,64,6349,4,5787,9814,6660,ITF,ITF3,15,Campania
2021-03-20,ABR,4733,2159,2574,318,15,509,60,3650,84,97,2569,2164,ITF,ITF1,13,Abruzzo
2021-01-17,SIC,1295,584,711,619,118,398,160,0,0,0,1245,50,ITG,ITG1,19,Sicilia
2021-02-14,MAR,738,301,437,578,2,158,0,0,0,0,738,0,ITI,ITI3,11,Marche
2021-02-23,LOM,11721,4780,6941,3944,1357,266,851,4310,990,3,11412,309,ITC,ITC4,3,Lombardia
2021-03-31,PAT,2547,983,1564,142,34,659,5,1474,6,227,1690,857,ITH,ITH2,4,Provincia Autonoma Trento
2021-01-18,CAL,1230,550,680,982,0,237,11,0,0,0,1040,190,ITF,ITF6,18,Calabria
2021-01-06,TOS,4519,1459,3060,3984,9,1,525,0,0,0,4519,0,ITI,ITI1,9,Toscana
2021-03-20,VEN,12899,5327,7572,697,31,4744,320,4728,7,2372,10803,2096,ITH,ITH3,5,Veneto
2021-03-06,CAL,7954,4060,3894,702,69,1804,758,3799,816,6,7198,756,ITF,ITF6,18,Calabria
2021-04-10,PUG,28405,12028,16377,554,97,16016,106,11304,62,266,24267,4138,ITF,ITF4,16,Puglia
2020-12-28,LIG,80,30,50,77,0,3,0,0,0,0,80,0,ITC,ITC3,7,Liguria
2021-02-05,PUG,5627,2270,3357,4565,503,13,526,0,14,6,1330,4297,ITF,ITF4,16,Puglia
2021-01-29,UMB,1221,343,878,934,16,0,271,0,0,0,79,1142,ITI,ITI2,10,Umbria
2021-01-08,MAR,1574,588,986,1226,0,348,0,0,0,0,1574,0,ITI,ITI3,11,Marche
2021-01-29,LAZ,7628,2879,4749,6373,259,186,704,106,0,0,510,7118,ITI,ITI4,12,Lazio
2021-03-04,CAM,14649,5349,9300,1901,290,1923,136,5562,1,4836,8756,5893,ITF,ITF3,15,Campania
2021-04-13,VDA,371,171,200,2,1,241,8,119,0,0,327,44,ITC,ITC2,2,Valle d'Aosta / Vallée d'Aoste
2021-04-03,PIE,19372,8108,11264,308,140,4845,76,13408,55,540,10827,8545,ITC,ITC1,1,Piemonte
2021-01-14,ABR,530,189,341,364,0,166,0,0,0,0,530,0,ITF,ITF1,13,Abruzzo
2021-01-26,MAR,2016,746,1270,1736,1,193,86,0,0,0,92,1924,ITI,ITI3,11,Marche
2021-03-16,UMB,3505,1434,2071,1634,68,20,65,1707,0,11,1878,1627,ITI,ITI2,10,Umbria
2021-02-28,LAZ,10224,3996,6228,1601,260,428,77,4577,682,2599,9710,514,ITI,ITI4,12,Lazio
2021-02-11,LAZ,6702,2809,3893,2197,174,175,500,3656,0,0,6463,239,ITI,ITI4,12,Lazio
2021-01-13,LOM,26211,8007,18204,15795,5732,297,4193,191,2,1,26211,0,ITC,ITC4,3,Lombardia
2021-02-22,PIE,8467,3464,5003,1705,802,626,512,3902,0,920,7877,590,ITC,ITC1,1,Piemonte
2020-12-29,SIC,235,146,89,235,0,0,0,0,0,0,235,0,ITG,ITG1,19,Sicilia
2021-01-28,CAL,2232,1107,1125,1920,1,311,0,0,0,0,84,2148,ITF,ITF6,18,Calabria
2021-03-22,PUG,9324,4547,4777,604,194,494,11,6751,209,1061,3692,5632,ITF,ITF4,16,Puglia
2021-04-07,CAL,6177,2798,3379,193,12,2930,395,2093,15,539,3629,2548,ITF,ITF6,18,Calabria
2021-03-29,TOS,9316,4534,4782,227,118,8380,218,20,153,200,8992,324,ITI,ITI1,9,Toscana
2021-01-21,PAB,952,442,510,750,88,14,68,27,5,0,139,813,ITH,ITH1,4,Provincia Autonoma Bolzano / Bozen
2021-01-27,VDA,151,71,80,55,8,17,18,53,0,0,79,72,ITC,ITC2,2,Valle d'Aosta / Vallée d'Aoste
2021-02-07,TOS,2806,953,1853,2349,299,1,157,0,0,0,885,1921,ITI,ITI1,9,Toscana
2021-03-06,SIC,12951,5183,7768,2003,127,1879,758,3888,646,3650,10045,2906,ITG,ITG1,19,Sicilia
2021-01-01,LAZ,3554,1382,2172,3483,0,3,68,0,0,0,3554,0,ITI,ITI4,12,Lazio
2021-03-22,SIC,16837,7929,8908,915,19,8701,356,5545,71,1230,11291,5546,ITG,ITG1,19,Sicilia
2021-03-26,LAZ,27733,12027,15706,5372,94,8805,330,9608,275,3249,21120,6613,ITI,ITI4,12,Lazio
2021-01-01,TOS,2369,787,1582,1715,2,0,650,2,0,0,2369,0,ITI,ITI1,9,Toscana
2021-04-10,SIC,20629,10074,10555,486,16,15388,278,4190,31,240,11594,9035,ITG,ITG1,19,Sicilia
2021-01-24,LIG,755,236,519,632,60,3,60,0,0,0,113,642,ITC,ITC3,7,Liguria
2021-01-04,SAR,591,217,374,565,15,11,0,0,0,0,591,0,ITG,ITG2,20,Sardegna
2021-03-08,MOL,1376,522,854,359,44,61,23,409,76,404,1236,140,ITF,ITF2,14,Molise
2021-02-27,PUG,14108,4780,9328,1587,552,155,181,5115,345,6173,12929,1179,ITF,ITF4,16,Puglia
2021-01-23,FVG,816,324,492,768,1,47,0,0,0,0,4,812,ITH,ITH4,6,Friuli-Venezia Giulia
2021-01-07,MOL,598,209,389,414,1,38,145,0,0,0,598,0,ITF,ITF2,14,Molise
2021-01-20,EMR,1321,269,1052,391,111,32,787,0,0,0,1320,1,ITH,ITH5,8,Emilia-Romagna
2021-03-07,FVG,2537,926,1611,1,1,157,0,143,453,1782,2536,1,ITH,ITH4,6,Friuli-Venezia Giulia
2021-03-25,LIG,9505,4046,5459,648,172,2845,170,3676,381,1613,6116,3389,ITC,ITC3,7,Liguria
2021-04-15,MAR,10371,4668,5703,503,5,8105,19,776,31,932,9806,565,ITI,ITI3,11,Marche
2021-02-13,MAR,1064,455,609,457,28,489,90,0,0,0,1012,52,ITI,ITI3,11,Marche
2021-03-24,LIG,8787,3766,5021,522,105,2137,61,4224,401,1337,5499,3288,ITC,ITC3,7,Liguria
2021-01-26,ABR,1542,567,975,1513,0,29,0,0,0,0,29,1513,ITF,ITF1,13,Abruzzo
2021-03-07,LIG,1858,1085,773,184,8,516,258,508,383,1,1557,301,ITC,ITC3,7,Liguria
2021-02-28,PIE,10812,4058,6754,642,344,167,53,6816,0,2790,10572,240,ITC,ITC1,1,Piemonte
2021-03-23,CAM,15334,7058,8276,359,488,6023,181,4730,260,3293,12829,2505,ITF,ITF3,15,Campania
2021-04-16,PUG,33245,15699,17546,673,104,27985,104,4137,33,209,30250,2995,ITF,ITF4,16,Puglia
2021-02-04,PAT,972,304,668,543,10,5,89,325,0,0,420,552,ITH,ITH2,4,Provincia Autonoma Trento
2021-04-01,VEN,24161,10512,13649,951,157,12234,583,10075,9,152,17792,6369,ITH,ITH3,5,Veneto
2021-03-23,LIG,8798,3986,4812,638,79,2310,56,3930,474,1311,5592,3206,ITC,ITC3,7,Liguria
2020-12-31,SAR,32,16,16,28,0,4,0,0,0,0,32,0,ITG,ITG2,20,Sardegna
2021-02-01,SAR,1524,605,919,896,151,400,77,0,0,0,225,1299,ITG,ITG2,20,Sardegna
2021-03-12,UMB,2633,1031,1602,113,410,183,41,464,229,1193,2135,498,ITI,ITI2,10,Umbria
2021-03-24,CAM,17619,8081,9538,410,71,7675,70,6718,232,2443,14668,2951,ITF,ITF3,15,Campania
2021-03-02,FVG,4220,1518,2702,1163,658,19,203,1538,5,634,2717,1503,ITH,ITH4,6,Friuli-Venezia Giulia
2021-01-24,CAM,4128,2123,2005,3140,410,412,166,0,0,0,383,3745,ITF,ITF3,15,Campania
2021-01-02,EMR,2352,905,1447,2074,1,79,198,0,0,0,2352,0,ITH,ITH5,8,Emilia-Romagna
2021-01-17,PUG,1308,590,718,818,153,1,336,0,0,0,1239,69,ITF,ITF4,16,Puglia
2021-03-25,CAM,19996,9340,10656,308,38,9540,8,7448,170,2484,16493,3503,ITF,ITF3,15,Campania
2021-03-19,VEN,13775,5663,8112,1949,152,2860,512,7559,16,727,7681,6094,ITH,ITH3,5,Veneto
2021-01-08,TOS,5944,1641,4303,5360,36,3,545,0,0,0,5944,0,ITI,ITI1,9,Toscana
2021-02-05,SIC,7216,3232,3984,3618,267,2475,856,0,0,0,2132,5084,ITG,ITG1,19,Sicilia
2021-03-09,VDA,204,96,108,2,0,79,23,36,39,25,172,32,ITC,ITC2,2,Valle d'Aosta / Vallée d'Aoste
2021-04-09,FVG,7525,3441,4084,287,167,4395,71,2583,0,22,6342,1183,ITH,ITH4,6,Friuli-Venezia Giulia
2021-03-14,LOM,14872,5348,9524,1520,573,1588,80,5265,396,5450,11583,3289,ITC,ITC4,3,Lombardia
2021-01-17,VEN,1932,780,1152,1588,40,179,120,3,0,2,1583,349,ITH,ITH3,5,Veneto
2021-02-24,FVG,2518,1082,1436,23,5,48,310,1835,0,297,2500,18,ITH,ITH4,6,Friuli-Venezia Giulia
2020-12-27,EMR,969,372,597,824,2,117,26,0,0,0,969,0,ITH,ITH5,8,Emilia-Romagna
2021-02-10,LOM,14386,4501,9885,8533,2328,103,3335,78,3,6,7569,6817,ITC,ITC4,3,Lombardia
2021-04-14,LIG,12388,5404,6984,447,125,7452,74,4203,26,61,10370,2018,ITC,ITC3,7,Liguria
2021-03-18,BAS,1346,561,785,30,0,10,0,1306,0,0,22,1324,ITF,ITF5,17,Basilicata
2021-04-09,UMB,6261,2928,3333,86,30,5400,24,634,2,85,6062,199,ITI,ITI2,10,Umbria
2021-04-14,FVG,5893,2570,3323,326,210,3422,73,1858,1,3,4534,1359,ITH,ITH4,6,Friuli-Venezia Giulia
2021-01-19,SAR,747,270,477,423,163,0,160,0,0,1,692,55,ITG,ITG2,20,Sardegna
2021-02-28,BAS,802,342,460,32,0,30,0,740,0,0,774,28,ITF,ITF5,17,Basilicata
2021-03-25,PAB,2123,1053,1070,215,68,1407,32,299,56,46,1696,427,ITH,ITH1,4,Provincia Autonoma Bolzano / Bozen
2020-12-30,SIC,173,101,72,156,3,14,0,0,0,0,173,0,ITG,ITG1,19,Sicilia
2021-02-07,UMB,54,17,37,46,8,0,0,0,0,0,1,53,ITI,ITI2,10,Umbria
2021-02-13,VDA,215,195,20,0,0,54,0,0,161,0,215,0,ITC,ITC2,2,Valle d'Aosta / Vallée d'Aoste
2021-01-19,VDA,256,77,179,160,10,14,15,57,0,0,256,0,ITC,ITC2,2,Valle d'Aosta / Vallée d'Aoste
2021-03-31,PUG,13776,6257,7519,1782,382,1999,123,8492,189,809,8225,5551,ITF,ITF4,16,Puglia
2021-01-20,MOL,18,8,10,14,4,0,0,0,0,0,18,0,ITF,ITF2,14,Molise
2021-02-08,PIE,6916,2355,4561,3786,1480,78,1572,0,0,0,666,6250,ITC,ITC1,1,Piemonte
2021-03-05,TOS,16442,6309,10133,3921,926,1485,170,5250,819,3871,11702,4740,ITI,ITI1,9,Toscana
2021-03-23,PAB,1552,759,793,0,0,1246,0,215,57,34,1551,1,ITH,ITH1,4,Provincia Autonoma Bolzano / Bozen
2021-04-14,LOM,46046,20611,25435,908,583,31212,611,11898,51,783,33338,12708,ITC,ITC4,3,Lombardia
2021-02-05,PAT,802,271,531,467,19,2,66,248,0,0,283,519,ITH,ITH2,4,Provincia Autonoma Trento
2021-04-10,PAT,2788,1304,1484,21,5,2496,1,67,11,187,1994,794,ITH,ITH2,4,Provincia Autonoma Trento
2021-02-26,SIC,12247,5977,6270,1837,74,1898,361,3891,1733,2453,10558,1689,ITG,ITG1,19,Sicilia
2021-03-11,MOL,1463,636,827,42,2,22,14,699,185,499,1457,6,ITF,ITF2,14,Molise
2021-03-22,PAT,2282,969,1313,82,132,969,8,970,18,103,1407,875,ITH,ITH2,4,Provincia Autonoma Trento
2021-03-04,MAR,6625,2976,3649,1064,8,930,106,2800,948,769,5231,1394,ITI,ITI3,11,Marche
2021-01-25,MOL,319,130,189,317,0,0,0,0,0,2,3,316,ITF,ITF2,14,Molise
2021-03-17,CAL,3637,1623,2014,277,49,931,165,2095,26,94,1939,1698,ITF,ITF6,18,Calabria
2021-02-11,FVG,1935,665,1270,1134,566,2,229,3,1,0,1742,193,ITH,ITH4,6,Friuli-Venezia Giulia
2021-03-24,PAB,2040,977,1063,13,11,1678,5,247,57,29,2027,13,ITH,ITH1,4,Provincia Autonoma Bolzano / Bozen
2021-02-21,BAS,284,113,171,16,1,1,11,254,0,1,284,0,ITF,ITF5,17,Basilicata
2021-02-25,BAS,1787,736,1051,67,2,12,0,1705,1,0,1741,46,ITF,ITF5,17,Basilicata
2021-01-05,PAB,830,286,544,734,61,35,0,0,0,0,830,0,ITH,ITH1,4,Provincia Autonoma Bolzano / Bozen
2021-02-12,MOL,330,149,181,224,12,20,72,0,0,2,208,122,ITF,ITF2,14,Molise
2020-12-27,LIG,135,56,79,88,0,2,45,0,0,0,135,0,ITC,ITC3,7,Liguria
2021-02-14,VDA,48,16,32,6,0,0,42,0,0,0,1,47,ITC,ITC2,2,Valle d'Aosta / Vallée d'Aoste
2021-03-12,LAZ,22682,10027,12655,4709,170,3255,400,9426,774,3948,16370,6312,ITI,ITI4,12,Lazio
2021-02-07,SAR,1116,394,722,975,136,5,0,0,0,0,228,888,ITG,ITG2,20,Sardegna
2021-04-06,VEN,28034,12872,15162,425,46,21643,387,5425,5,103,22966,5068,ITH,ITH3,5,Veneto
2021-01-05,TOS,5243,1754,3489,4354,9,2,878,0,0,0,5243,0,ITI,ITI1,9,Toscana
2021-01-26,VDA,139,48,91,115,11,1,12,0,0,0,0,139,ITC,ITC2,2,Valle d'Aosta / Vallée d'Aoste
2021-01-23,LAZ,6963,2718,4245,6063,247,77,417,159,0,0,335,6628,ITI,ITI4,12,Lazio
2021-02-12,VDA,263,96,167,51,9,39,28,131,0,5,217,46,ITC,ITC2,2,Valle d'Aosta / Vallée d'Aoste
2021-04-11,MOL,1146,579,567,0,0,1098,0,48,0,0,1133,13,ITF,ITF2,14,Molise
2021-02-04,PUG,5896,2356,3540,4444,649,144,653,0,0,6,1167,4729,ITF,ITF4,16,Puglia
2021-01-10,LOM,10518,3957,6561,8175,2159,85,85,11,2,1,10518,0,ITC,ITC4,3,Lombardia
2021-01-11,MOL,557,194,363,196,193,57,111,0,0,0,557,0,ITF,ITF2,14,Molise
2021-02-25,ABR,3086,1347,1739,615,29,528,18,1508,262,126,2558,528,ITF,ITF1,13,Abruzzo
2021-03-03,LOM,26897,11486,15411,6403,1651,4534,1797,10178,1863,471,19626,7271,ITC,ITC4,3,Lombardia
2021-01-17,PAT,251,195,56,251,0,0,0,0,0,0,251,0,ITH,ITH2,4,Provincia Autonoma Trento
2020-12-27,PAB,144,65,79,139,2,2,0,1,0,0,144,0,ITH,ITH1,4,Provincia Autonoma Bolzano / Bozen
2021-03-20,FVG,3346,1353,1993,412,275,25,8,2381,179,66,1252,2094,ITH,ITH4,6,Friuli-Venezia Giulia
2021-01-12,TOS,3581,1398,2183,2944,282,1,354,0,0,0,3581,0,ITI,ITI1,9,Toscana
2021-02-24,VEN,8611,3677,4934,1586,227,482,521,5592,189,14,8126,485,ITH,ITH3,5,Veneto
2021-02-06,PUG,4511,1917,2594,3494,483,4,527,0,0,3,1590,2921,ITF,ITF4,16,Puglia
2021-01-05,EMR,9346,3167,6179,7927,279,370,770,0,0,0,9346,0,ITH,ITH5,8,Emilia-Romagna
2021-02-09,SIC,4371,1831,2540,2241,155,1335,640,0,0,0,3365,1006,ITG,ITG1,19,Sicilia
2021-04-04,LAZ,17368,8006,9362,397,38,10176,11,6689,15,42,12137,5231,ITI,ITI4,12,Lazio
2021-02-03,VDA,351,114,237,157,135,6,52,1,0,0,14,337,ITC,ITC2,2,Valle d'Aosta / Vallée d'Aoste
2021-02-26,CAL,3079,1631,1448,539,57,631,407,1147,294,4,2611,468,ITF,ITF6,18,Calabria
2021-02-13,CAM,5509,2550,2959,960,99,701,131,3616,0,2,5292,217,ITF,ITF3,15,Campania
2021-01-12,LAZ,5391,1974,3417,4343,342,122,584,0,0,0,5391,0,ITI,ITI4,12,Lazio
2021-03-28,VEN,31284,13597,17687,1452,45,17838,172,9307,29,2441,27598,3686,ITH,ITH3,5,Veneto
2021-02-17,FVG,2352,998,1354,328,178,15,230,1555,46,0,1873,479,ITH,ITH4,6,Friuli-Venezia Giulia
2021-02-22,BAS,1790,773,1017,125,18,68,2,1577,0,0,1737,53,ITF,ITF5,17,Basilicata
2021-04-16,PAT,2732,1291,1441,79,25,2248,22,350,0,8,2595,137,ITH,ITH2,4,Provincia Autonoma Trento
2021-03-17,SIC,15420,7568,7852,1402,100,7179,664,5726,43,306,9474,5946,ITG,ITG1,19,Sicilia
2021-02-22,SIC,8039,4162,3877,1107,34,902,554,4066,1054,322,7547,492,ITG,ITG1,19,Sicilia
2021-01-16,LAZ,5427,2127,3300,3358,241,260,1064,504,0,0,5427,0,ITI,ITI4,12,Lazio
2021-02-21,PIE,5086,2080,3006,685,190,75,47,3352,0,737,4984,102,ITC,ITC1,1,Piemonte
2021-02-08,TOS,4097,1360,2737,3373,343,2,377,2,0,0,3638,459,ITI,ITI1,9,Toscana
2021-01-30,TOS,4622,1622,3000,3765,218,1,638,0,0,0,198,4424,ITI,ITI1,9,Toscana
2021-01-25,VDA,147,65,82,125,13,3,6,0,0,0,0,147,ITC,ITC2,2,Valle d'Aosta / Vallée d'Aoste
2021-04-12,VDA,479,181,298,8,8,219,22,220,0,2,319,160,ITC,ITC2,2,Valle d'Aosta / Vallée d'Aoste
2021-02-10,ABR,948,313,635,622,42,168,116,0,0,0,504,444,ITF,ITF1,13,Abruzzo
2021-02-16,FVG,2516,1135,1381,260,244,31,221,1760,0,0,2400,116,ITH,ITH4,6,Friuli-Venezia Giulia
2021-02-08,BAS,557,193,364,436,49,23,49,0,0,0,151,406,ITF,ITF5,17,Basilicata
2021-01-18,SAR,904,326,578,714,173,17,0,0,0,0,780,124,ITG,ITG2,20,Sardegna
2021-03-11,EMR,17190,7106,10084,1133,296,1534,277,8823,1312,3815,11339,5851,ITH,ITH5,8,Emilia-Romagna
2021-01-25,LOM,7023,2371,4652,5631,912,248,218,14,0,0,488,6535,ITC,ITC4,3,Lombardia
2021-02-12,LOM,13817,4326,9491,8098,2663,95,2851,102,5,3,9024,4793,ITC,ITC4,3,Lombardia
2021-02-14,CAL,371,145,226,146,13,129,83,0,0,0,341,30,ITF,ITF6,18,Calabria
2021-01-27,LOM,8042,2676,5366,6202,1248,155,434,1,0,2,820,7222,ITC,ITC4,3,Lombardia
2021-01-30,UMB,1577,483,1094,841,18,0,717,1,0,0,44,1533,ITI,ITI2,10,Umbria
2021-03-19,SIC,16504,8124,8380,1262,101,8731,561,5351,42,456,10776,5728,ITG,ITG1,19,Sicilia
2021-03-25,UMB,3875,1691,2184,256,51,160,63,3265,48,32,2811,1064,ITI,ITI2,10,Umbria
2021-03-14,PAB,758,336,422,130,11,26,33,557,1,0,25,733,ITH,ITH1,4,Provincia Autonoma Bolzano / Bozen
2021-03-16,FVG,3142,1283,1859,327,255,112,244,2203,0,1,1062,2080,ITH,ITH4,6,Friuli-Venezia Giulia
2021-02-20,ABR,4782,1843,2939,310,7,563,192,1417,406,1887,4706,76,ITF,ITF1,13,Abruzzo
2021-03-27,CAL,8292,3763,4529,306,4,3198,144,3216,24,1400,4458,3834,ITF,ITF6,18,Calabria
2021-02-18,PUG,4367,1842,2525,2701,913,56,680,5,10,2,3764,603,ITF,ITF4,16,Puglia
2021-03-18,EMR,13650,5797,7853,448,124,2144,76,10806,3,49,5654,7996,ITH,ITH5,8,Emilia-Romagna
2021-02-09,FVG,1848,556,1292,1053,509,0,286,0,0,0,1559,289,ITH,ITH4,6,Friuli-Venezia Giulia
2021-03-30,SAR,7871,3102,4769,649,224,2375,207,2935,29,1452,5892,1979,ITG,ITG2,20,Sardegna
2021-01-27,LIG,1745,604,1141,1338,89,90,227,0,0,1,142,1603,ITC,ITC3,7,Liguria
2021-04-19,LIG,6500,2809,3691,246,45,4005,31,2050,12,111,4266,2234,ITC,ITC3,7,Liguria
2021-03-09,LOM,33221,12841,20380,6076,2534,2793,2385,12524,1427,5482,25788,7433,ITC,ITC4,3,Lombardia
2021-03-04,LIG,4734,2117,2617,920,106,217,289,2916,282,4,3891,843,ITC,ITC3,7,Liguria
2021-01-30,PAB,498,245,253,217,44,136,101,0,0,0,4,494,ITH,ITH1,4,Provincia Autonoma Bolzano / Bozen
2021-01-07,EMR,10215,3384,6831,8187,287,673,1068,0,0,0,10215,0,ITH,ITH5,8,Emilia-Romagna
2021-01-16,PAT,319,148,171,304,0,0,15,0,0,0,319,0,ITH,ITH2,4,Provincia Autonoma Trento
2021-01-24,UMB,254,104,150,254,0,0,0,0,0,0,1,253,ITI,ITI2,10,Umbria
2021-02-06,LOM,15240,5525,9715,9845,2933,488,1896,74,1,3,1083,14157,ITC,ITC4,3,Lombardia
2021-02-18,PAT,1205,426,779,300,25,5,35,782,3,55,1143,62,ITH,ITH2,4,Provincia Autonoma Trento
2021-02-23,EMR,8214,3218,4996,409,91,234,113,7366,0,1,7828,386,ITH,ITH5,8,Emilia-Romagna
2021-01-10,ABR,1139,409,730,1091,0,48,0,0,0,0,1139,0,ITF,ITF1,13,Abruzzo
2021-04-19,CAM,18030,8841,9189,127,33,14339,42,3273,35,181,8789,9241,ITF,ITF3,15,Campania
2021-01-15,LAZ,6281,2498,3783,4498,417,214,988,164,0,0,6281,0,ITI,ITI4,12,Lazio
2021-04-03,PUG,9964,4279,5685,919,93,2910,122,5366,14,540,6420,3544,ITF,ITF4,16,Puglia
2021-02-12,VEN,4313,1447,2866,2768,141,728,659,6,3,8,3741,572,ITH,ITH3,5,Veneto
2021-03-09,LIG,5804,2701,3103,1031,148,517,131,3444,533,0,4379,1425,ITC,ITC3,7,Liguria
2021-01-25,VEN,6467,2075,4392,5065,152,338,904,6,0,2,167,6300,ITH,ITH3,5,Veneto
2021-03-31,VDA,550,300,250,6,0,362,0,182,0,0,525,25,ITC,ITC2,2,Valle d'Aosta / Vallée d'Aoste
2021-01-07,VDA,275,111,164,224,38,8,5,0,0,0,275,0,ITC,ITC2,2,Valle d'Aosta / Vallée d'Aoste
2021-02-04,MOL,758,295,463,502,76,38,141,0,0,1,77,681,ITF,ITF2,14,Molise
2021-01-10,PIE,5214,2275,2939,3912,765,18,519,0,0,0,5214,0,ITC,ITC1,1,Piemonte
2021-01-06,SIC,6471,3402,3069,5717,24,728,2,0,0,0,6471,0,ITG,ITG1,19,Sicilia
2021-04-15,SIC,21369,10395,10974,800,24,15941,316,4150,26,112,11799,9570,ITG,ITG1,19,Sicilia
2021-04-18,BAS,3718,1845,1873,29,5,2324,0,1341,3,16,2351,1367,ITF,ITF5,17,Basilicata
2021-02-01,VDA,403,127,276,268,56,9,70,0,0,0,87,316,ITC,ITC2,2,Valle d'Aosta / Vallée d'Aoste
2021-03-08,MAR,6366,2807,3559,768,14,604,219,3102,644,1015,5364,1002,ITI,ITI3,11,Marche
2021-04-07,MOL,1658,834,824,36,8,1337,62,109,26,80,1383,275,ITF,ITF2,14,Molise
2021-03-05,VEN,13175,4910,8265,3547,268,1749,1429,3090,138,2954,9592,3583,ITH,ITH3,5,Veneto
2021-02-28,PAT,242,121,121,231,0,0,0,0,0,11,242,0,ITH,ITH2,4,Provincia Autonoma Trento
2021-03-14,LIG,1658,752,906,66,36,345,176,577,27,431,1054,604,ITC,ITC3,7,Liguria
2021-03-02,MOL,667,383,284,98,106,12,51,136,113,151,509,158,ITF,ITF2,14,Molise
2021-01-21,LAZ,5296,2133,3163,4780,78,48,232,158,0,0,245,5051,ITI,ITI4,12,Lazio
2021-02-13,LOM,6410,2440,3970,4174,1416,86,709,17,4,4,4937,1473,ITC,ITC4,3,Lombardia
2021-04-06,PAT,2241,945,1296,39,5,1016,9,1054,17,101,1488,753,ITH,ITH2,4,Provincia Autonoma Trento
2021-04-08,MOL,1726,889,837,105,12,1391,6,172,5,35,1525,201,ITF,ITF2,14,Molise
2021-01-08,SIC,8328,3864,4464,6591,87,1437,213,0,0,0,8328,0,ITG,ITG1,19,Sicilia
2021-03-25,FVG,5289,2249,3040,53,56,2049,186,2057,53,835,3155,2134,ITH,ITH4,6,Friuli-Venezia Giulia
2021-04-03,BAS,1805,751,1054,39,1,343,0,1104,4,314,1469,336,ITF,ITF5,17,Basilicata
2021-01-11,VEN,7237,2100,5137,3500,504,1021,1956,248,0,8,7237,0,ITH,ITH3,5,Veneto
2021-01-15,VEN,5862,1818,4044,2981,460,840,1565,9,3,4,5862,0,ITH,ITH3,5,Veneto
2021-04-11,VEN,20856,8808,12048,1003,11,11206,83,8206,2,345,14549,6307,ITH,ITH3,5,Veneto
2021-01-03,SAR,90,36,54,89,1,0,0,0,0,0,90,0,ITG,ITG2,20,Sardegna
2021-03-31,MOL,2138,896,1242,202,8,785,32,799,49,263,1319,819,ITF,ITF2,14,Molise
2021-03-29,BAS,2683,986,1697,71,0,154,0,1780,4,674,2343,340,ITF,ITF5,17,Basilicata
2021-03-28,PAT,746,290,456,18,386,262,0,8,70,2,743,3,ITH,ITH2,4,Provincia Autonoma Trento
2021-01-30,SAR,3862,1392,2470,2987,500,374,0,1,0,0,362,3500,ITG,ITG2,20,Sardegna
2021-02-15,FVG,2454,909,1545,700,386,19,315,1034,0,0,2204,250,ITH,ITH4,6,Friuli-Venezia Giulia
2021-01-29,MAR,1991,730,1261,1479,4,434,74,0,0,0,168,1823,ITI,ITI3,11,Marche
2021-04-14,PIE,27020,12273,14747,854,345,18519,445,6789,9,59,22531,4489,ITC,ITC1,1,Piemonte
2021-02-02,LAZ,5793,2146,3647,4712,367,132,571,11,0,0,522,5271,ITI,ITI4,12,Lazio
2021-04-04,MOL,253,141,112,1,0,249,0,3,0,0,238,15,ITF,ITF2,14,Molise
2021-02-01,CAM,3985,1813,2172,2504,656,673,152,0,0,0,110,3875,ITF,ITF3,15,Campania
2020-12-27,UMB,85,45,40,67,2,0,16,0,0,0,85,0,ITI,ITI2,10,Umbria
2021-03-24,UMB,4069,1758,2311,215,98,169,1,3507,37,42,2746,1323,ITI,ITI2,10,Umbria
2021-01-16,MAR,2006,723,1283,1059,43,619,285,0,0,0,2006,0,ITI,ITI3,11,Marche
2021-04-03,PAT,1130,470,660,141,250,585,0,57,66,31,965,165,ITH,ITH2,4,Provincia Autonoma Trento
2021-01-02,CAM,3673,1962,1711,3167,340,166,0,0,0,0,3673,0,ITF,ITF3,15,Campania
2021-03-14,ABR,1895,733,1162,8,0,150,0,1488,0,249,1228,667,ITF,ITF1,13,Abruzzo
2021-03-23,UMB,3793,1685,2108,395,179,206,12,2852,89,60,2164,1629,ITI,ITI2,10,Umbria
2021-01-20,CAM,1257,650,607,395,146,615,101,0,0,0,1257,0,ITF,ITF3,15,Campania
2021-04-07,EMR,25601,11636,13965,661,113,11561,140,12742,24,360,19633,5968,ITH,ITH5,8,Emilia-Romagna
2021-01-21,SAR,126,60,66,60,44,22,0,0,0,0,94,32,ITG,ITG2,20,Sardegna
2021-03-09,CAM,13839,6619,7220,797,266,2762,184,4495,1148,4187,10058,3781,ITF,ITF3,15,Campania
2021-04-16,LOM,51554,23194,28360,1671,553,35600,839,12448,60,383,37965,13589,ITC,ITC4,3,Lombardia
2021-04-12,VEN,14631,6205,8426,492,27,7002,122,6035,14,939,6516,8115,ITH,ITH3,5,Veneto
2021-03-12,MAR,4717,2020,2697,820,10,723,0,1905,330,929,3472,1245,ITI,ITI3,11,Marche
2021-01-08,CAL,2109,1014,1095,1898,0,211,0,0,0,0,2109,0,ITF,ITF6,18,Calabria
2021-01-12,PIE,10046,3404,6642,6862,1921,93,1170,0,0,0,10046,0,ITC,ITC1,1,Piemonte
2021-01-24,PAB,12,10,2,1,0,11,0,0,0,0,0,12,ITH,ITH1,4,Provincia Autonoma Bolzano / Bozen
2021-03-21,PIE,10586,4679,5907,585,414,1367,9,6893,0,1318,4063,6523,ITC,ITC1,1,Piemonte
2021-04-05,CAM,11636,5541,6095,141,19,8114,6,2878,46,432,9215,2421,ITF,ITF3,15,Campania
2021-02-21,LAZ,6821,3111,3710,1245,53,325,51,4524,607,16,6520,301,ITI,ITI4,12,Lazio
2021-04-01,LAZ,27749,12739,15010,5798,91,12372,284,8669,287,248,20652,7097,ITI,ITI4,12,Lazio
2021-03-01,SIC,12981,6130,6851,1558,75,1735,392,4303,1765,3153,11322,1659,ITG,ITG1,19,Sicilia
2021-01-26,CAL,1805,861,944,1571,18,146,70,0,0,0,285,1520,ITF,ITF6,18,Calabria
2021-04-12,LOM,46831,20437,26394,1127,758,29105,492,13640,49,1660,32589,14242,ITC,ITC4,3,Lombardia
2021-01-03,CAL,6,3,3,4,0,2,0,0,0,0,6,0,ITF,ITF6,18,Calabria
2021-02-14,LIG,233,122,111,31,0,30,112,60,0,0,233,0,ITC,ITC3,7,Liguria
2021-03-28,SIC,11003,5166,5837,535,22,5632,168,4445,14,187,6989,4014,ITG,ITG1,19,Sicilia
2021-02-22,PAT,745,259,486,119,4,6,70,501,0,45,661,84,ITH,ITH2,4,Provincia Autonoma Trento
2021-01-09,FVG,2518,841,1677,1519,2,404,593,0,0,0,2518,0,ITH,ITH4,6,Friuli-Venezia Giulia
2021-03-08,VDA,481,231,250,28,1,80,13,343,15,1,237,244,ITC,ITC2,2,Valle d'Aosta / Vallée d'Aoste
2021-03-29,PIE,15102,6351,8751,416,328,2451,137,10362,78,1330,8497,6605,ITC,ITC1,1,Piemonte
2021-01-29,TOS,6136,1698,4438,5375,138,1,622,0,0,0,302,5834,ITI,ITI1,9,Toscana
2021-01-27,CAM,7738,3820,3918,5839,875,754,270,0,0,0,163,7575,ITF,ITF3,15,Campania
2021-02-11,MOL,293,133,160,225,19,0,45,0,3,1,257,36,ITF,ITF2,14,Molise
2021-01-26,LIG,2483,803,1680,1964,152,110,252,0,0,5,13,2470,ITC,ITC3,7,Liguria
2021-03-01,MOL,661,274,387,200,28,41,108,135,2,147,447,214,ITF,ITF2,14,Molise
2021-03-15,BAS,2347,981,1366,78,26,20,0,1934,23,266,520,1827,ITF,ITF5,17,Basilicata
2021-03-30,VDA,399,221,178,9,0,257,5,121,2,5,380,19,ITC,ITC2,2,Valle d'Aosta / Vallée d'Aoste
2021-03-26,MAR,6345,2614,3731,335,21,1322,182,3928,56,501,3534,2811,ITI,ITI3,11,Marche
2021-02-17,PAB,4,1,3,1,0,2,0,1,0,0,2,2,ITH,ITH1,4,Provincia Autonoma Bolzano / Bozen
2021-03-12,TOS,16448,6183,10265,2611,955,997,303,6964,696,3922,12924,3524,ITI,ITI1,9,Toscana
2021-02-01,MAR,1365,480,885,1057,1,226,81,0,0,0,98,1267,ITI,ITI3,11,Marche
2021-01-12,SIC,4543,2235,2308,2863,128,1357,195,0,0,0,4543,0,ITG,ITG1,19,Sicilia
2021-02-23,PAB,768,323,445,0,0,58,0,625,0,85,762,6,ITH,ITH1,4,Provincia Autonoma Bolzano / Bozen
2021-04-13,MAR,9860,4275,5585,203,5,7578,41,944,14,1075,9619,241,ITI,ITI3,11,Marche
2021-03-13,FVG,2934,1119,1815,12,4,12,86,2058,39,723,1661,1273,ITH,ITH4,6,Friuli-Venezia Giulia
2021-01-28,EMR,10233,3333,6900,8071,296,742,1124,0,0,0,352,9881,ITH,ITH5,8,Emilia-Romagna
2020-12-31,SIC,878,470,408,828,0,50,0,0,0,0,878,0,ITG,ITG1,19,Sicilia
2021-03-08,VEN,13489,6153,7336,713,56,1953,384,7166,270,2947,9430,4059,ITH,ITH3,5,Veneto
2021-04-13,CAL,6489,3197,3292,245,25,4728,28,1272,85,106,5231,1258,ITF,ITF6,18,Calabria
2021-02-02,BAS,365,141,224,212,15,36,102,0,0,0,175,190,ITF,ITF5,17,Basilicata
2020-12-27,LAZ,272,131,141,272,0,0,0,0,0,0,272,0,ITI,ITI4,12,Lazio
2021-03-28,PUG,3500,1642,1858,634,54,715,47,1928,3,119,1177,2323,ITF,ITF4,16,Puglia
2021-04-15,VEN,20138,8318,11820,624,91,9592,467,8675,3,686,9358,10780,ITH,ITH3,5,Veneto
2021-03-19,PAT,2410,911,1499,320,70,842,53,1055,2,68,1571,839,ITH,ITH2,4,Provincia Autonoma Trento
2021-04-06,PUG,13041,5776,7265,698,176,3449,126,8319,62,211,6468,6573,ITF,ITF4,16,Puglia
2021-03-13,MOL,1189,594,595,29,0,23,5,981,151,0,200,989,ITF,ITF2,14,Molise
2021-03-21,TOS,3232,1574,1658,660,792,1677,77,8,6,12,1799,1433,ITI,ITI1,9,Toscana
2021-02-15,LAZ,7791,3414,4377,2447,362,365,379,4230,8,0,7430,361,ITI,ITI4,12,Lazio
2021-04-15,PUG,30882,14387,16495,544,120,25003,37,5023,36,119,27417,3465,ITF,ITF4,16,Puglia
2021-01-31,CAM,8066,3711,4355,5106,1012,1881,67,0,0,0,23,8043,ITF,ITF3,15,Campania
2021-02-03,SAR,1119,419,700,920,169,11,19,0,0,0,426,693,ITG,ITG2,20,Sardegna
2021-01-21,UMB,610,202,408,428,13,0,169,0,0,0,341,269,ITI,ITI2,10,Umbria
2021-01-05,SIC,10527,5159,5368,9074,122,1124,207,0,0,0,10527,0,ITG,ITG1,19,Sicilia
2021-03-10,PUG,14367,6228,8139,2599,919,329,355,6485,603,3077,11252,3115,ITF,ITF4,16,Puglia
2021-03-26,MOL,2560,1038,1522,70,5,839,23,1005,70,548,1918,642,ITF,ITF2,14,Molise
2021-03-03,EMR,15753,5226,10527,2530,352,766,141,6814,341,4809,13295,2458,ITH,ITH5,8,Emilia-Romagna
2021-04-19,PAB,1811,828,983,44,21,1569,0,165,1,11,1629,182,ITH,ITH1,4,Provincia Autonoma Bolzano / Bozen
2021-04-17,PUG,36201,17208,18993,497,48,31063,74,4317,37,165,33027,3174,ITF,ITF4,16,Puglia
2021-04-03,LAZ,24134,10792,13342,4690,65,11259,111,7772,30,207,17493,6641,ITI,ITI4,12,Lazio
2021-03-15,PIE,10643,4154,6489,1716,924,573,231,5730,0,1469,5028,5615,ITC,ITC1,1,Piemonte
2021-01-20,FVG,751,323,428,719,1,31,0,0,0,0,12,739,ITH,ITH4,6,Friuli-Venezia Giulia
2021-03-07,EMR,6847,2633,4214,1459,324,715,22,2564,514,1249,5330,1517,ITH,ITH5,8,Emilia-Romagna
2021-03-29,LIG,10384,4487,5897,463,127,4705,115,3909,182,883,7255,3129,ITC,ITC3,7,Liguria
2021-01-30,BAS,703,226,477,424,81,72,126,0,0,0,127,576,ITF,ITF5,17,Basilicata
2021-01-19,CAM,1095,474,621,534,129,261,171,0,0,0,1092,3,ITF,ITF3,15,Campania
2021-02-05,ABR,1536,521,1015,1188,11,230,107,0,0,0,789,747,ITF,ITF1,13,Abruzzo
2021-03-11,CAM,17575,8666,8909,1049,255,3013,105,8933,1384,2836,10299,7276,ITF,ITF3,15,Campania
2021-04-15,PAB,4394,2305,2089,119,44,3859,38,173,43,118,4131,263,ITH,ITH1,4,Provincia Autonoma Bolzano / Bozen
2021-01-05,FVG,1680,551,1129,1350,1,132,197,0,0,0,1680,0,ITH,ITH4,6,Friuli-Venezia Giulia
2021-04-18,VDA,513,251,262,9,5,480,3,12,0,4,509,4,ITC,ITC2,2,Valle d'Aosta / Vallée d'Aoste
2021-02-26,LAZ,12923,5620,7303,1909,533,823,352,5181,1385,2740,11679,1244,ITI,ITI4,12,Lazio
2021-01-02,LOM,199,72,127,178,16,5,0,0,0,0,199,0,ITC,ITC4,3,Lombardia
2021-03-30,PIE,16823,6996,9827,782,355,2190,287,12114,101,994,8953,7870,ITC,ITC1,1,Piemonte
2021-04-16,UMB,7850,3627,4223,166,9,5520,96,1868,11,180,6013,1837,ITI,ITI2,10,Umbria
2021-02-17,LAZ,8845,4392,4453,2282,226,230,499,4262,1345,1,8283,562,ITI,ITI4,12,Lazio
2021-02-10,MOL,150,78,72,91,6,0,53,0,0,0,130,20,ITF,ITF2,14,Molise
2021-01-23,EMR,2446,870,1576,1902,4,110,430,0,0,0,443,2003,ITH,ITH5,8,Emilia-Romagna
2021-01-28,CAM,8833,4122,4711,6216,1094,1176,347,0,0,0,135,8698,ITF,ITF3,15,Campania
2021-01-12,LIG,2460,886,1574,1750,174,95,439,0,0,2,2460,0,ITC,ITC3,7,Liguria
2021-01-22,SIC,1235,625,610,1035,13,69,118,0,0,0,242,993,ITG,ITG1,19,Sicilia
2021-02-19,PAT,927,358,569,170,37,16,93,582,1,28,869,58,ITH,ITH2,4,Provincia Autonoma Trento
2021-02-12,LAZ,6543,2668,3875,1995,136,305,302,3805,0,0,6417,126,ITI,ITI4,12,Lazio
2021-04-14,MOL,1783,759,1024,44,1,1289,11,430,5,3,1132,651,ITF,ITF2,14,Molise
2021-02-02,LOM,19827,6577,13250,13492,4416,155,1680,76,7,1,489,19338,ITC,ITC4,3,Lombardia
2021-01-25,LAZ,7828,3078,4750,7006,205,121,363,133,0,0,488,7340,ITI,ITI4,12,Lazio
2021-01-20,LOM,5578,1364,4214,2743,1174,45,1557,59,0,0,5463,115,ITC,ITC4,3,Lombardia
2021-03-02,EMR,11732,3871,7861,1959,336,471,224,5323,373,3046,9732,2000,ITH,ITH5,8,Emilia-Romagna
2021-02-19,PUG,4728,2009,2719,3063,998,220,389,2,49,7,4338,390,ITF,ITF4,16,Puglia
2021-03-21,MAR,4512,1878,2634,87,0,109,54,4047,10,205,1632,2880,ITI,ITI3,11,Marche
2021-03-26,CAL,7644,3625,4019,511,21,3412,211,2382,68,1039,4531,3113,ITF,ITF6,18,Calabria
2021-02-03,BAS,666,300,366,425,15,54,172,0,0,0,32,634,ITF,ITF5,17,Basilicata
2021-01-21,MAR,896,253,643,460,41,59,336,0,0,0,585,311,ITI,ITI3,11,Marche
2021-03-05,VDA,275,124,151,51,8,60,13,138,0,5,53,222,ITC,ITC2,2,Valle d'Aosta / Vallée d'Aoste
2021-01-02,CAL,165,94,71,165,0,0,0,0,0,0,165,0,ITF,ITF6,18,Calabria
2021-01-28,PAT,530,147,383,390,29,4,107,0,0,0,48,482,ITH,ITH2,4,Provincia Autonoma Trento
2021-01-16,VDA,236,80,156,127,32,4,22,51,0,0,236,0,ITC,ITC2,2,Valle d'Aosta / Vallée d'Aoste
2021-01-24,CAL,44,18,26,15,0,3,26,0,0,0,39,5,ITF,ITF6,18,Calabria
2021-01-14,EMR,8093,2576,5517,5398,497,591,1606,0,1,0,8093,0,ITH,ITH5,8,Emilia-Romagna
2021-04-16,ABR,7157,3300,3857,156,7,5483,43,1430,6,32,5490,1667,ITF,ITF1,13,Abruzzo
2021-04-06,VDA,739,379,360,24,3,477,1,234,0,0,627,112,ITC,ITC2,2,Valle d'Aosta / Vallée d'Aoste
2021-01-14,VEN,7061,1924,5137,3240,526,783,2491,17,0,4,7061,0,ITH,ITH3,5,Veneto
2021-02-15,MOL,144,70,74,117,8,4,15,0,0,0,141,3,ITF,ITF2,14,Molise
2021-04-02,SAR,8680,3406,5274,524,199,2525,164,3936,31,1301,5716,2964,ITG,ITG2,20,Sardegna
2021-04-16,SAR,13944,6265,7679,474,101,9007,105,4216,14,27,8766,5178,ITG,ITG2,20,Sardegna
2021-03-16,PAT,1390,505,885,221,7,49,36,1073,0,4,607,783,ITH,ITH2,4,Provincia Autonoma Trento
2021-02-14,PUG,784,348,436,681,32,0,70,0,0,1,662,122,ITF,ITF4,16,Puglia
2021-01-04,CAM,5826,2963,2863,4850,679,297,0,0,0,0,5826,0,ITF,ITF3,15,Campania
2021-01-24,SAR,90,34,56,89,0,1,0,0,0,0,5,85,ITG,ITG2,20,Sardegna
2021-01-30,PIE,5978,2135,3843,4367,1049,67,495,0,0,0,218,5760,ITC,ITC1,1,Piemonte
2021-02-04,FVG,2731,807,1924,1723,543,0,465,0,0,0,36,2695,ITH,ITH4,6,Friuli-Venezia Giulia
2021-03-28,LIG,1141,510,631,135,92,236,145,532,1,0,390,751,ITC,ITC3,7,Liguria
2020-12-28,CAL,6,2,4,6,0,0,0,0,0,0,6,0,ITF,ITF6,18,Calabria
2021-01-04,PAT,870,227,643,486,41,6,336,1,0,0,870,0,ITH,ITH2,4,Provincia Autonoma Trento
2021-02-11,EMR,4245,1414,2831,2528,351,300,719,345,0,2,3406,839,ITH,ITH5,8,Emilia-Romagna
2021-04-01,CAL,8350,3772,4578,455,36,3118,669,2915,41,1116,3848,4502,ITF,ITF6,18,Calabria
2021-01-15,LOM,25071,7407,17664,13759,5827,432,4736,309,2,6,25071,0,ITC,ITC4,3,Lombardia
2021-04-16,PIE,26813,12530,14283,926,388,19469,262,5689,4,75,22255,4558,ITC,ITC1,1,Piemonte
2021-02-01,LIG,2551,917,1634,1945,171,54,380,0,0,1,85,2466,ITC,ITC3,7,Liguria
2021-04-09,PAT,2671,1132,1539,86,24,1471,27,864,4,195,1504,1167,ITH,ITH2,4,Provincia Autonoma Trento
2021-04-09,CAM,29807,13947,15860,261,43,21070,38,7309,128,958,23690,6117,ITF,ITF3,15,Campania
2021-04-07,VEN,35208,15792,19416,1591,334,26597,717,5592,20,357,27889,7319,ITH,ITH3,5,Veneto
2021-03-06,LAZ,18032,6925,11107,3700,113,1265,327,7923,932,3772,13778,4254,ITI,ITI4,12,Lazio
2021-02-25,PAT,1639,642,997,120,9,8,32,1376,1,93,1199,440,ITH,ITH2,4,Provincia Autonoma Trento
2021-04-15,LIG,11248,4952,6296,478,123,6783,135,3604,67,58,9453,1795,ITC,ITC3,7,Liguria
2021-01-30,ABR,1510,567,943,1349,1,113,47,0,0,0,69,1441,ITF,ITF1,13,Abruzzo
2021-03-24,SAR,7031,2882,4149,739,159,1518,392,2980,184,1059,5673,1358,ITG,ITG2,20,Sardegna
2021-02-04,VDA,294,86,208,168,74,17,34,1,0,0,8,286,ITC,ITC2,2,Valle d'Aosta / Vallée d'Aoste
2021-04-19,UMB,3478,1547,1931,147,23,1314,24,1959,0,11,1493,1985,ITI,ITI2,10,Umbria
2021-04-06,FVG,6125,2710,3415,247,192,2917,52,2669,19,29,5007,1118,ITH,ITH4,6,Friuli-Venezia Giulia
2021-04-18,MAR,8829,4131,4698,259,3,7732,0,376,4,455,7912,917,ITI,ITI3,11,Marche
2021-01-01,SIC,815,437,378,740,0,75,0,0,0,0,815,0,ITG,ITG1,19,Sicilia
2021-04-11,LAZ,18934,8375,10559,490,29,11952,50,6379,3,31,13069,5865,ITI,ITI4,12,Lazio
2021-01-03,PAT,492,160,332,419,9,1,63,0,0,0,492,0,ITH,ITH2,4,Provincia Autonoma Trento
2021-04-14,EMR,26440,12567,13873,652,148,18195,133,7225,26,61,20491,5949,ITH,ITH5,8,Emilia-Romagna
2021-02-20,MOL,1018,441,577,20,4,53,8,933,0,0,998,20,ITF,ITF2,14,Molise
2021-02-22,UMB,1859,778,1081,736,89,27,1,1006,0,0,1773,86,ITI,ITI2,10,Umbria
2021-01-02,ABR,548,218,330,540,0,8,0,0,0,0,548,0,ITF,ITF1,13,Abruzzo
2021-02-28,VDA,260,86,174,78,31,26,24,94,3,4,77,183,ITC,ITC2,2,Valle d'Aosta / Vallée d'Aoste
2021-03-10,TOS,17927,7030,10897,3005,850,1385,271,12188,214,14,13919,4008,ITI,ITI1,9,Toscana
2021-01-29,SIC,9363,4323,5040,7154,174,1730,305,0,0,0,432,8931,ITG,ITG1,19,Sicilia
2021-01-13,PIE,10080,3223,6857,6486,2040,225,1329,0,0,0,10080,0,ITC,ITC1,1,Piemonte
2021-01-17,UMB,54,17,37,47,7,0,0,0,0,0,54,0,ITI,ITI2,10,Umbria
2021-03-24,CAL,7366,3360,4006,386,23,2326,696,2375,65,1495,4190,3176,ITF,ITF6,18,Calabria
2021-04-13,PIE,25313,11373,13940,631,199,17249,259,6848,6,121,21901,3412,ITC,ITC1,1,Piemonte
2021-02-08,LIG,1977,742,1235,1256,218,185,311,0,0,7,306,1671,ITC,ITC3,7,Liguria
2021-02-19,TOS,8286,2947,5339,2967,1207,28,245,154,580,3105,7779,507,ITI,ITI1,9,Toscana
2021-03-18,SIC,15628,7784,7844,1284,80,8209,598,5359,61,37,9916,5712,ITG,ITG1,19,Sicilia
2021-03-13,EMR,16038,6298,9740,1250,161,1290,75,8244,1028,3990,10728,5310,ITH,ITH5,8,Emilia-Romagna
2021-03-23,CAL,5207,2442,2765,280,4,1847,47,1869,77,1083,3409,1798,ITF,ITF6,18,Calabria
2021-01-03,BAS,900,344,556,790,45,63,0,0,0,2,900,0,ITF,ITF5,17,Basilicata
2021-03-22,SAR,3493,1323,2170,838,152,412,109,781,66,1135,2981,512,ITG,ITG2,20,Sardegna
2021-01-05,CAL,1350,618,732,1256,0,94,0,0,0,0,1350,0,ITF,ITF6,18,Calabria
2021-03-11,LOM,36088,13426,22662,5874,2407,2191,2189,15542,1216,6669,26217,9871,ITC,ITC4,3,Lombardia
2021-01-19,PAT,405,77,328,365,3,1,36,0,0,0,405,0,ITH,ITH2,4,Provincia Autonoma Trento
2021-04-14,VEN,14951,6486,8465,770,89,8499,181,5275,6,131,8575,6376,ITH,ITH3,5,Veneto
2021-01-18,MOL,114,48,66,97,14,3,0,0,0,0,114,0,ITF,ITF2,14,Molise
2021-02-11,VEN,4014,1240,2774,2663,156,387,789,10,1,8,3384,630,ITH,ITH3,5,Veneto
2021-03-19,UMB,1734,561,1173,462,144,118,68,192,26,724,1078,656,ITI,ITI2,10,Umbria
2021-01-16,CAL,2394,1120,1274,1664,22,467,241,0,0,0,2394,0,ITF,ITF6,18,Calabria
2021-01-16,FVG,1231,360,871,771,1,211,248,0,0,0,1231,0,ITH,ITH4,6,Friuli-Venezia Giulia
2021-02-02,CAM,5722,2804,2918,3640,828,900,354,0,0,0,443,5279,ITF,ITF3,15,Campania
2021-04-12,LAZ,23174,10405,12769,1465,64,13987,101,7412,73,72,16339,6835,ITI,ITI4,12,Lazio
2021-03-28,PAB,569,212,357,45,38,15,0,469,0,2,11,558,ITH,ITH1,4,Provincia Autonoma Bolzano / Bozen
2021-04-10,SAR,10101,4549,5552,153,44,6106,11,3560,9,218,8167,1934,ITG,ITG2,20,Sardegna
2021-03-28,UMB,1095,442,653,65,8,20,5,936,24,37,1071,24,ITI,ITI2,10,Umbria
2020-12-28,PIE,1,1,0,1,0,0,0,0,0,0,1,0,ITC,ITC1,1,Piemonte
2021-01-12,VEN,5230,1516,3714,2250,359,688,1753,175,0,5,5230,0,ITH,ITH3,5,Veneto
2021-03-07,VEN,4453,1742,2711,1747,6,865,23,981,0,831,3900,553,ITH,ITH3,5,Veneto
2021-01-11,LOM,16024,5324,10700,11817,3305,158,699,42,1,2,16024,0,ITC,ITC4,3,Lombardia
2021-01-10,BAS,77,24,53,9,2,66,0,0,0,0,77,0,ITF,ITF5,17,Basilicata
2021-03-21,VDA,353,164,189,2,4,312,0,1,6,28,353,0,ITC,ITC2,2,Valle d'Aosta / Vallée d'Aoste
2021-04-09,PUG,20761,8889,11872,1095,359,8905,134,9802,52,414,16136,4625,ITF,ITF4,16,Puglia
2021-03-02,VEN,11441,4611,6830,2841,463,1403,1197,3286,383,1868,8166,3275,ITH,ITH3,5,Veneto
2021-04-01,FVG,6264,2968,3296,170,109,3589,193,2052,57,94,5250,1014,ITH,ITH4,6,Friuli-Venezia Giulia
2021-03-15,CAM,12912,6081,6831,808,131,2547,75,6279,511,2561,8192,4720,ITF,ITF3,15,Campania
2021-02-06,PIE,7983,2664,5319,5101,1528,103,1251,0,0,0,400,7583,ITC,ITC1,1,Piemonte
2021-02-06,SAR,1970,697,1273,1544,237,49,139,0,0,1,569,1401,ITG,ITG2,20,Sardegna
2021-02-03,CAM,8902,4002,4900,4736,1101,2350,714,1,0,0,878,8024,ITF,ITF3,15,Campania
2021-03-16,PUG,9769,4643,5126,2168,520,337,76,6568,62,38,3436,6333,ITF,ITF4,16,Puglia
2021-01-06,FVG,710,264,446,515,0,195,0,0,0,0,710,0,ITH,ITH4,6,Friuli-Venezia Giulia
2021-01-31,VDA,290,90,200,231,31,10,18,0,0,0,58,232,ITC,ITC2,2,Valle d'Aosta / Vallée d'Aoste
2021-03-30,CAL,5788,2486,3302,166,7,2369,200,1883,42,1121,3195,2593,ITF,ITF6,18,Calabria
2021-02-03,PAT,846,314,532,356,13,10,73,394,0,0,414,432,ITH,ITH2,4,Provincia Autonoma Trento
2021-01-03,PUG,2007,943,1064,1818,38,5,145,0,0,1,2007,0,ITF,ITF4,16,Puglia
2021-01-12,PAB,1709,459,1250,369,228,537,479,96,0,0,1709,0,ITH,ITH1,4,Provincia Autonoma Bolzano / Bozen
2021-01-23,VEN,4051,1247,2804,3406,119,85,437,1,0,3,34,4017,ITH,ITH3,5,Veneto
2021-03-30,BAS,2897,1181,1716,37,0,148,0,2193,7,512,2552,345,ITF,ITF5,17,Basilicata
2021-04-08,CAM,28261,13633,14628,283,62,19457,58,7191,169,1041,22427,5834,ITF,ITF3,15,Campania
2021-02-05,BAS,983,443,540,611,36,145,191,0,0,0,64,919,ITF,ITF5,17,Basilicata
2021-02-25,PUG,11885,5035,6850,1746,563,270,419,5781,726,2380,10729,1156,ITF,ITF4,16,Puglia
2021-03-19,LIG,5280,2229,3051,734,162,457,137,3686,21,83,2149,3131,ITC,ITC3,7,Liguria
2021-02-13,SAR,1456,565,891,732,400,65,254,0,0,5,1454,2,ITG,ITG2,20,Sardegna
2021-01-15,CAM,4980,2381,2599,2740,832,1217,191,0,0,0,4980,0,ITF,ITF3,15,Campania
2021-02-14,PAT,246,186,60,246,0,0,0,0,0,0,11,235,ITH,ITH2,4,Provincia Autonoma Trento
2021-03-17,LAZ,13568,5787,7781,1511,87,2270,255,9424,7,14,7337,6231,ITI,ITI4,12,Lazio
2020-12-27,TOS,620,267,353,460,10,137,13,0,0,0,620,0,ITI,ITI1,9,Toscana
2021-03-12,SIC,13124,5620,7504,1387,110,4410,695,3770,345,2407,10900,2224,ITG,ITG1,19,Sicilia
2021-02-06,ABR,1611,742,869,1168,29,342,72,0,0,0,602,1009,ITF,ITF1,13,Abruzzo
2021-04-09,VEN,30848,13587,17261,1429,147,18541,580,9947,6,198,22536,8312,ITH,ITH3,5,Veneto
2021-01-13,BAS,916,387,529,699,11,57,148,0,0,1,916,0,ITF,ITF5,17,Basilicata
2021-02-27,SIC,12450,5570,6880,1515,72,2351,277,3843,1021,3371,11239,1211,ITG,ITG1,19,Sicilia
2021-04-10,PIE,30025,13346,16679,896,315,18336,138,10194,12,134,25728,4297,ITC,ITC1,1,Piemonte
2021-04-05,VDA,458,221,237,18,0,398,0,8,0,34,455,3,ITC,ITC2,2,Valle d'Aosta / Vallée d'Aoste
2021-03-11,FVG,3327,1393,1934,262,109,47,287,2014,104,504,1578,1749,ITH,ITH4,6,Friuli-Venezia Giulia
2021-04-14,CAM,27623,13319,14304,268,49,21859,22,5099,58,268,19059,8564,ITF,ITF3,15,Campania
2021-02-08,SAR,1470,533,937,998,315,30,126,1,0,0,856,614,ITG,ITG2,20,Sardegna
2021-03-24,BAS,1542,626,916,67,0,62,0,953,43,417,1189,353,ITF,ITF5,17,Basilicata
2021-03-25,EMR,21297,9312,11985,1094,245,7287,162,9863,561,2085,14358,6939,ITH,ITH5,8,Emilia-Romagna
2021-02-11,PAB,1091,431,660,213,92,266,104,416,0,0,239,852,ITH,ITH1,4,Provincia Autonoma Bolzano / Bozen
2021-04-12,MOL,1251,546,705,17,1,1144,1,87,1,0,1009,242,ITF,ITF2,14,Molise
2021-04-02,BAS,2308,1043,1265,97,0,447,0,1729,10,25,1701,607,ITF,ITF5,17,Basilicata
2021-02-10,PAB,1635,604,1031,489,165,232,1,748,0,0,26,1609,ITH,ITH1,4,Provincia Autonoma Bolzano / Bozen
2021-03-14,LAZ,17053,6598,10455,1362,89,3295,81,8335,445,3446,11899,5154,ITI,ITI4,12,Lazio
2021-02-18,VDA,349,153,196,61,4,36,45,181,14,8,261,88,ITC,ITC2,2,Valle d'Aosta / Vallée d'Aoste
2021-03-22,PIE,11402,4817,6585,874,459,754,181,7913,0,1221,3819,7583,ITC,ITC1,1,Piemonte
2021-03-04,PIE,14479,5727,8752,2186,872,1087,609,7535,0,2190,11530,2949,ITC,ITC1,1,Piemonte
2021-02-11,UMB,842,349,493,735,98,1,5,0,0,3,837,5,ITI,ITI2,10,Umbria
2021-01-24,BAS,834,299,535,706,46,81,1,0,0,0,58,776,ITF,ITF5,17,Basilicata
2021-03-21,LIG,552,221,331,7,1,19,0,525,0,0,69,483,ITC,ITC3,7,Liguria
2021-02-06,BAS,902,367,535,546,115,72,168,0,0,1,146,756,ITF,ITF5,17,Basilicata
2021-01-28,FVG,2236,792,1444,1755,0,287,194,0,0,0,354,1882,ITH,ITH4,6,Friuli-Venezia Giulia
2021-04-16,BAS,3353,1646,1707,32,1,2365,0,881,4,70,2439,914,ITF,ITF5,17,Basilicata
2021-04-13,PAT,2522,1041,1481,25,12,1422,1,673,2,387,2015,507,ITH,ITH2,4,Provincia Autonoma Trento
2021-03-11,CAL,6877,3278,3599,934,25,2039,570,2380,329,600,5621,1256,ITF,ITF6,18,Calabria
2021-03-01,LAZ,16723,7143,9580,1555,527,1253,385,8018,1406,3579,12865,3858,ITI,ITI4,12,Lazio
2021-02-16,LAZ,8091,3886,4205,2058,102,501,261,4217,951,1,7791,300,ITI,ITI4,12,Lazio
2020-12-30,TOS,327,104,223,34,10,0,283,0,0,0,327,0,ITI,ITI1,9,Toscana
2021-04-13,PUG,27434,13026,14408,661,176,21344,31,5089,15,118,24111,3323,ITF,ITF4,16,Puglia
2021-02-19,VDA,292,102,190,17,0,22,35,153,0,65,268,24,ITC,ITC2,2,Valle d'Aosta / Vallée d'Aoste
2021-01-11,ABR,1551,557,994,1337,62,104,48,0,0,0,1551,0,ITF,ITF1,13,Abruzzo
2021-03-27,VEN,31893,13898,17995,2027,42,15780,169,12294,32,1549,26061,5832,ITH,ITH3,5,Veneto
2020-12-30,PAT,7,3,4,4,1,0,2,0,0,0,7,0,ITH,ITH2,4,Provincia Autonoma Trento
2021-01-01,SAR,30,16,14,30,0,0,0,0,0,0,30,0,ITG,ITG2,20,Sardegna
2021-03-24,PIE,15469,6330,9139,1072,502,1031,479,11508,37,840,6343,9126,ITC,ITC1,1,Piemonte
2021-01-03,CAM,3837,2009,1828,3191,401,245,0,0,0,0,3837,0,ITF,ITF3,15,Campania
2021-04-08,CAL,9373,4408,4965,451,25,4737,524,3302,30,304,5695,3678,ITF,ITF6,18,Calabria
2021-03-23,PIE,12977,5389,7588,689,325,1170,222,9237,0,1334,6740,6237,ITC,ITC1,1,Piemonte
2021-02-13,MOL,132,80,52,129,3,0,0,0,0,0,132,0,ITF,ITF2,14,Molise
2021-04-10,CAL,11174,5032,6142,424,5,4407,447,5562,26,303,6343,4831,ITF,ITF6,18,Calabria
2021-03-22,BAS,1172,529,643,46,49,38,0,638,16,385,626,546,ITF,ITF5,17,Basilicata
2021-03-02,LOM,22808,9689,13119,3192,1345,2904,2199,11260,1778,130,19778,3030,ITC,ITC4,3,Lombardia
2021-03-22,CAL,4708,2203,2505,194,10,1198,147,1994,40,1125,3041,1667,ITF,ITF6,18,Calabria
2021-01-26,PUG,5359,2397,2962,4850,243,33,232,1,0,0,573,4786,ITF,ITF4,16,Puglia
2021-03-16,TOS,4885,1875,3010,1551,424,669,124,2089,12,16,2649,2236,ITI,ITI1,9,Toscana
2021-01-02,PIE,3544,1134,2410,3078,336,77,53,0,0,0,3544,0,ITC,ITC1,1,Piemonte
2021-03-27,EMR,21509,9003,12506,752,232,8496,42,9503,149,2335,14617,6892,ITH,ITH5,8,Emilia-Romagna
2021-03-10,SIC,13987,5975,8012,1481,134,2926,948,4067,665,3766,11596,2391,ITG,ITG1,19,Sicilia
2021-01-12,UMB,784,247,537,665,7,7,105,0,0,0,784,0,ITI,ITI2,10,Umbria
2021-04-07,LOM,49968,20684,29284,1717,1120,7244,1148,36222,61,2456,34289,15679,ITC,ITC4,3,Lombardia
2021-02-17,MAR,1791,664,1127,968,24,498,300,1,0,0,1672,119,ITI,ITI3,11,Marche
2021-03-09,EMR,14588,5932,8656,1024,241,789,180,7591,1197,3566,10636,3952,ITH,ITH5,8,Emilia-Romagna
2021-01-23,LOM,1114,357,757,644,258,74,138,0,0,0,916,198,ITC,ITC4,3,Lombardia
2021-03-25,PAT,2846,1098,1748,183,136,812,28,1305,25,357,1798,1048,ITH,ITH2,4,Provincia Autonoma Trento
2021-01-21,SIC,1331,649,682,1003,86,104,138,0,0,0,500,831,ITG,ITG1,19,Sicilia
2021-01-05,PUG,5098,2245,2853,4747,158,86,98,5,0,4,5098,0,ITF,ITF4,16,Puglia
2021-04-17,SIC,26119,13208,12911,324,13,21629,205,3837,22,89,18970,7149,ITG,ITG1,19,Sicilia
2021-01-24,PIE,3152,958,2194,2634,344,28,146,0,0,0,434,2718,ITC,ITC1,1,Piemonte
2021-01-29,LIG,3077,1064,2013,2312,205,117,441,0,0,2,67,3010,ITC,ITC3,7,Liguria
2021-01-04,VDA,142,59,83,126,14,2,0,0,0,0,142,0,ITC,ITC2,2,Valle d'Aosta / Vallée d'Aoste
2021-02-10,EMR,3998,1374,2624,2393,222,359,768,256,0,0,2756,1242,ITH,ITH5,8,Emilia-Romagna
2021-02-25,VDA,201,101,100,6,3,153,12,0,25,2,194,7,ITC,ITC2,2,Valle d'Aosta / Vallée d'Aoste
2021-03-13,VEN,17155,7235,9920,2586,63,5433,109,4812,110,4042,14048,3107,ITH,ITH3,5,Veneto
2021-01-08,LAZ,7726,2894,4832,6519,191,218,798,0,0,0,7726,0,ITI,ITI4,12,Lazio
2021-04-08,LOM,51261,21394,29867,2219,1029,8980,896,36540,49,1548,34913,16348,ITC,ITC4,3,Lombardia
2021-01-27,EMR,8355,2945,5410,6903,225,554,672,0,1,0,464,7891,ITH,ITH5,8,Emilia-Romagna
2021-03-07,CAM,11911,5344,6567,533,109,1302,85,4019,1512,4351,8070,3841,ITF,ITF3,15,Campania
2021-04-10,BAS,1036,383,653,64,0,318,2,147,19,486,954,82,ITF,ITF5,17,Basilicata
2021-03-06,TOS,7095,2838,4257,3803,482,1132,145,30,357,1146,2905,4190,ITI,ITI1,9,Toscana
2021-01-15,CAL,2793,1258,1535,1690,35,656,412,0,0,0,2793,0,ITF,ITF6,18,Calabria
2021-01-01,PAB,2,2,0,2,0,0,0,0,0,0,2,0,ITH,ITH1,4,Provincia Autonoma Bolzano / Bozen
2021-04-19,SAR,6869,3124,3745,145,55,5569,73,991,1,35,5751,1118,ITG,ITG2,20,Sardegna
2021-02-11,LOM,16954,4993,11961,9702,3286,58,3865,33,4,6,9613,7341,ITC,ITC4,3,Lombardia
2021-03-30,CAM,21667,10253,11414,278,45,13525,165,5648,170,1836,18712,2955,ITF,ITF3,15,Campania
2021-03-06,MAR,5732,2647,3085,973,4,833,125,2400,650,747,4464,1268,ITI,ITI3,11,Marche
2021-04-03,VDA,673,339,334,13,4,592,4,54,5,1,658,15,ITC,ITC2,2,Valle d'Aosta / Vallée d'Aoste
2021-01-27,MOL,674,251,423,436,11,17,209,0,0,1,8,666,ITF,ITF2,14,Molise
2021-02-13,BAS,799,313,486,279,125,79,115,199,2,0,738,61,ITF,ITF5,17,Basilicata
2021-02-27,LIG,1888,921,967,139,13,527,5,1204,0,0,1759,129,ITC,ITC3,7,Liguria
2021-02-20,EMR,5298,2087,3211,408,95,145,155,4495,0,0,5034,264,ITH,ITH5,8,Emilia-Romagna
2021-03-02,ABR,3964,1676,2288,934,15,424,53,1857,276,405,3280,684,ITF,ITF1,13,Abruzzo
2021-03-04,SAR,4002,1953,2049,987,309,553,542,1095,474,42,2747,1255,ITG,ITG2,20,Sardegna
2021-01-10,PUG,2348,1060,1288,2037,101,8,202,0,0,0,2348,0,ITF,ITF4,16,Puglia
2021-02-10,VEN,4750,1587,3163,3173,228,566,775,6,0,2,3697,1053,ITH,ITH3,5,Veneto
2021-02-15,EMR,2895,847,2048,1983,325,141,157,289,0,0,2769,126,ITH,ITH5,8,Emilia-Romagna
2021-01-13,CAM,8019,3665,4354,4350,1031,2051,587,0,0,0,8019,0,ITF,ITF3,15,Campania
2021-03-03,LAZ,17117,7226,9891,2111,200,1182,379,8059,1249,3937,12827,4290,ITI,ITI4,12,Lazio
2021-04-08,ABR,7350,3321,4029,156,11,4269,73,2629,9,203,5069,2281,ITF,ITF1,13,Abruzzo
2021-01-29,PAB,1496,510,986,882,282,31,295,2,0,4,23,1473,ITH,ITH1,4,Provincia Autonoma Bolzano / Bozen
2021-01-20,CAL,1395,622,773,864,6,346,179,0,0,0,1394,1,ITF,ITF6,18,Calabria
2021-03-30,PUG,11689,5445,6244,1321,216,1853,198,7023,119,959,5828,5861,ITF,ITF4,16,Puglia
2021-03-17,MAR,3435,1497,1938,301,5,178,117,2822,7,5,111,3324,ITI,ITI3,11,Marche
2021-03-18,UMB,2831,1100,1731,975,116,19,246,1460,3,12,1593,1238,ITI,ITI2,10,Umbria
2021-03-18,PAB,1299,530,769,50,15,161,48,1025,0,0,223,1076,ITH,ITH1,4,Provincia Autonoma Bolzano / Bozen
2021-02-26,MOL,563,260,303,42,7,50,3,406,0,55,490,73,ITF,ITF2,14,Molise
2021-03-30,PAT,2379,970,1409,71,57,965,53,1048,9,176,1742,637,ITH,ITH2,4,Provincia Autonoma Trento
2021-01-06,LAZ,5119,1960,3159,4619,45,133,320,0,1,1,5119,0,ITI,ITI4,12,Lazio
2021-01-08,UMB,1173,337,836,926,8,1,238,0,0,0,1173,0,ITI,ITI2,10,Umbria
2021-03-19,FVG,3221,1335,1886,106,47,131,290,2513,0,134,1288,1933,ITH,ITH4,6,Friuli-Venezia Giulia
2021-02-27,EMR,10950,3992,6958,1726,178,316,114,7676,0,940,9218,1732,ITH,ITH5,8,Emilia-Romagna
2021-01-07,CAM,8910,4166,4744,6313,1087,1178,332,0,0,0,8910,0,ITF,ITF3,15,Campania
2021-04-04,VEN,7765,3524,4241,23,0,6401,1,1325,2,13,6615,1150,ITH,ITH3,5,Veneto
2021-02-11,PUG,3695,1401,2294,2570,389,11,723,0,0,2,2419,1276,ITF,ITF4,16,Puglia
2020-12-31,PAB,911,518,393,477,61,373,0,0,0,0,911,0,ITH,ITH1,4,Provincia Autonoma Bolzano / Bozen
2021-02-04,SAR,2271,816,1455,1737,307,56,170,1,0,0,916,1355,ITG,ITG2,20,Sardegna
2021-02-01,CAL,2497,1192,1305,2044,4,406,43,0,0,0,248,2249,ITF,ITF6,18,Calabria
2021-04-05,UMB,4249,1728,2521,764,16,717,69,2651,6,26,2193,2056,ITI,ITI2,10,Umbria
2021-04-12,ABR,6093,2879,3214,216,4,4529,44,1249,15,36,4974,1119,ITF,ITF1,13,Abruzzo
2021-01-01,PIE,1038,395,643,922,116,0,0,0,0,0,1038,0,ITC,ITC1,1,Piemonte
2021-01-17,FVG,1720,524,1196,674,5,555,486,0,0,0,1720,0,ITH,ITH4,6,Friuli-Venezia Giulia
2021-03-09,PUG,13147,5739,7408,1864,496,388,225,5624,1010,3540,11150,1997,ITF,ITF4,16,Puglia
2021-04-07,PIE,23475,9924,13551,951,344,8983,268,12341,55,533,18030,5445,ITC,ITC1,1,Piemonte
2021-04-08,BAS,879,405,474,260,0,318,0,80,33,188,870,9,ITF,ITF5,17,Basilicata
2021-01-14,CAL,2557,1214,1343,1962,0,592,3,0,0,0,2557,0,ITF,ITF6,18,Calabria
2021-04-10,VEN,27194,11851,15343,581,45,15208,406,10832,7,115,18717,8477,ITH,ITH3,5,Veneto
2021-03-09,SIC,13244,5633,7611,1595,132,2288,614,3951,965,3699,10868,2376,ITG,ITG1,19,Sicilia
2021-04-19,MOL,1469,699,770,14,4,1241,51,138,15,6,802,667,ITF,ITF2,14,Molise
2021-01-11,PIE,8741,2980,5761,6054,1485,76,1126,0,0,0,8741,0,ITC,ITC1,1,Piemonte
2021-04-02,VEN,23598,10373,13225,1090,60,11899,364,9862,25,298,17275,6323,ITH,ITH3,5,Veneto
2021-02-11,SAR,1315,490,825,588,240,117,369,1,0,0,1204,111,ITG,ITG2,20,Sardegna
2021-01-11,BAS,183,66,117,107,15,20,41,0,0,0,183,0,ITF,ITF5,17,Basilicata
2021-01-28,BAS,903,401,502,717,24,80,81,1,0,0,119,784,ITF,ITF5,17,Basilicata
2021-02-02,PIE,10236,3507,6729,6870,1980,69,1317,0,0,0,815,9421,ITC,ITC1,1,Piemonte
2021-02-04,LAZ,6089,2309,3780,4460,354,293,892,90,0,0,950,5139,ITI,ITI4,12,Lazio
2021-04-05,CAL,3445,1627,1818,133,3,1835,148,1181,11,134,2544,901,ITF,ITF6,18,Calabria
2021-02-15,UMB,1368,692,676,10,4,3,0,1351,0,0,1367,1,ITI,ITI2,10,Umbria
2021-02-24,SIC,9601,4870,4731,1423,80,1174,499,4028,1474,923,9005,596,ITG,ITG1,19,Sicilia
2021-04-06,LAZ,23530,10537,12993,2204,82,13108,94,7678,200,164,16537,6993,ITI,ITI4,12,Lazio
2021-04-07,SAR,13132,5838,7294,675,260,6228,255,5343,21,350,7635,5497,ITG,ITG2,20,Sardegna
2021-03-11,BAS,1783,919,864,163,63,99,77,905,253,223,824,959,ITF,ITF5,17,Basilicata
2021-01-17,MOL,78,38,40,78,0,0,0,0,0,0,48,30,ITF,ITF2,14,Molise
2021-04-14,SAR,7470,3498,3972,144,22,6428,96,762,1,17,6350,1120,ITG,ITG2,20,Sardegna
2021-03-19,MOL,1180,479,701,32,0,163,9,726,2,248,753,427,ITF,ITF2,14,Molise
2021-02-06,PAT,574,298,276,179,0,4,0,391,0,0,433,141,ITH,ITH2,4,Provincia Autonoma Trento
2021-04-14,PAB,3588,1643,1945,417,114,2863,18,124,22,30,3496,92,ITH,ITH1,4,Provincia Autonoma Bolzano / Bozen
2021-03-07,PAB,114,13,101,59,28,23,0,3,0,1,9,105,ITH,ITH1,4,Provincia Autonoma Bolzano / Bozen
2021-02-17,PUG,4265,1743,2522,2462,1170,32,598,1,1,1,3666,599,ITF,ITF4,16,Puglia
2021-04-18,SAR,5031,2189,2842,48,0,1577,0,3393,10,3,2274,2757,ITG,ITG2,20,Sardegna
2021-01-02,LAZ,6705,2630,4075,6269,47,31,358,0,0,0,6705,0,ITI,ITI4,12,Lazio
2020-12-27,VEN,880,395,485,875,0,4,0,0,0,1,880,0,ITH,ITH3,5,Veneto
2021-03-09,LAZ,20823,8921,11902,3381,104,2188,338,8965,1230,4617,15629,5194,ITI,ITI4,12,Lazio
2021-03-23,PUG,10372,4977,5395,1852,308,650,51,6054,466,991,3918,6454,ITF,ITF4,16,Puglia
2021-02-19,BAS,1622,737,885,219,356,19,66,962,0,0,1560,62,ITF,ITF5,17,Basilicata
2021-03-26,BAS,1927,697,1230,195,0,68,0,1188,1,475,1665,262,ITF,ITF5,17,Basilicata
2021-04-03,VEN,21700,9508,12192,1345,39,11487,150,8541,9,129,13967,7733,ITH,ITH3,5,Veneto
2021-03-07,MAR,5183,2108,3075,607,2,355,0,3007,316,896,4430,753,ITI,ITI3,11,Marche
2021-01-03,EMR,2753,941,1812,2503,12,68,170,0,0,0,2753,0,ITH,ITH5,8,Emilia-Romagna
2021-03-24,PUG,12891,5942,6949,1906,469,677,161,7891,245,1542,5671,7220,ITF,ITF4,16,Puglia
2021-01-28,TOS,6282,1883,4399,5427,64,2,788,1,0,0,354,5928,ITI,ITI1,9,Toscana
2021-01-06,LOM,7057,2489,4568,5846,1021,150,38,0,0,2,7057,0,ITC,ITC4,3,Lombardia
2021-01-20,PAB,617,252,365,287,51,22,0,257,0,0,409,208,ITH,ITH1,4,Provincia Autonoma Bolzano / Bozen
2021-02-24,MOL,666,278,388,242,61,44,44,274,0,1,333,333,ITF,ITF2,14,Molise
2021-02-10,PIE,7453,2347,5106,3856,1463,37,2097,0,0,0,1316,6137,ITC,ITC1,1,Piemonte
2021-02-23,SIC,8949,4689,4260,1267,103,1133,502,3996,1367,581,8459,490,ITG,ITG1,19,Sicilia
2021-04-02,MAR,6991,3031,3960,389,3,3271,108,2657,140,423,6248,743,ITI,ITI3,11,Marche
2021-04-17,UMB,6475,2982,3493,158,15,4763,14,1392,6,127,5133,1342,ITI,ITI2,10,Umbria
2021-04-10,ABR,8275,3801,4474,389,28,4835,11,2845,20,147,5767,2508,ITF,ITF1,13,Abruzzo
2021-01-04,EMR,7267,2513,4754,6172,123,393,578,0,1,0,7267,0,ITH,ITH5,8,Emilia-Romagna
2021-01-27,SAR,1408,494,914,1303,75,30,0,0,0,0,79,1329,ITG,ITG2,20,Sardegna
2021-01-12,MAR,1226,413,813,912,0,264,50,0,0,0,1226,0,ITI,ITI3,11,Marche
2021-02-11,ABR,816,262,554,473,26,163,154,0,0,0,773,43,ITF,ITF1,13,Abruzzo
2021-01-08,BAS,554,219,335,383,30,82,59,0,0,0,554,0,ITF,ITF5,17,Basilicata
2021-03-16,ABR,3486,1453,2033,284,3,163,169,2849,6,12,1831,1655,ITF,ITF1,13,Abruzzo
2021-04-19,SIC,13330,6362,6968,513,18,9925,235,2557,16,66,8402,4928,ITG,ITG1,19,Sicilia
2021-01-31,PIE,4106,1748,2358,3077,636,18,375,0,0,0,112,3994,ITC,ITC1,1,Piemonte
2021-03-01,LOM,18766,8217,10549,2717,1065,1601,927,10818,1609,29,17062,1704,ITC,ITC4,3,Lombardia
2021-03-04,LAZ,18269,7775,10494,2800,211,1355,507,8176,1315,3905,13256,5013,ITI,ITI4,12,Lazio
2021-03-26,VDA,494,203,291,4,2,170,0,89,3,226,487,7,ITC,ITC2,2,Valle d'Aosta / Vallée d'Aoste
2021-01-22,FVG,90,30,60,89,0,1,0,0,0,0,0,90,ITH,ITH4,6,Friuli-Venezia Giulia
2021-03-09,MOL,1329,579,750,199,1,109,0,409,218,393,1177,152,ITF,ITF2,14,Molise
2021-04-15,UMB,4609,2085,2524,181,28,2472,36,1862,8,22,3645,964,ITI,ITI2,10,Umbria
2021-02-22,SAR,1637,948,689,606,239,170,180,2,440,0,1409,228,ITG,ITG2,20,Sardegna
2021-03-27,MOL,2707,1263,1444,18,3,802,0,1880,3,1,1274,1433,ITF,ITF2,14,Molise
2021-03-14,TOS,7207,2574,4633,3104,798,452,122,44,211,2476,3272,3935,ITI,ITI1,9,Toscana
2020-12-30,PUG,1,0,1,1,0,0,0,0,0,0,1,0,ITF,ITF4,16,Puglia
2020-12-27,SIC,90,54,36,62,0,2,26,0,0,0,90,0,ITG,ITG1,19,Sicilia
2021-03-12,PAB,1658,734,924,149,123,690,73,435,87,101,1251,407,ITH,ITH1,4,Provincia Autonoma Bolzano / Bozen
2021-02-23,LAZ,10947,4699,6248,1897,109,507,309,5200,1015,1910,10302,645,ITI,ITI4,12,Lazio
2021-04-15,SAR,11007,5124,5883,264,70,6699,126,3803,25,20,6174,4833,ITG,ITG2,20,Sardegna
2021-01-22,LIG,1814,603,1211,1065,143,41,565,0,0,0,1328,486,ITC,ITC3,7,Liguria
2021-02-15,VEN,4386,1821,2565,485,65,164,383,3273,14,2,4145,241,ITH,ITH3,5,Veneto
2021-03-31,LAZ,25707,11836,13871,4262,82,11777,135,8985,220,246,18728,6979,ITI,ITI4,12,Lazio
2021-02-09,TOS,4488,1468,3020,3582,386,2,514,4,0,0,3877,611,ITI,ITI1,9,Toscana
2021-02-20,SIC,7285,3737,3548,848,76,1258,558,3750,620,175,7033,252,ITG,ITG1,19,Sicilia
2021-03-25,PUG,10710,5188,5522,1262,317,901,53,7131,387,659,4558,6152,ITF,ITF4,16,Puglia
2021-02-09,LAZ,8480,3541,4939,3258,244,395,548,4035,0,0,4575,3905,ITI,ITI4,12,Lazio
2021-01-15,FVG,2028,606,1422,1283,6,364,375,0,0,0,2028,0,ITH,ITH4,6,Friuli-Venezia Giulia
2021-01-14,LOM,26703,7765,18938,15189,5525,306,5451,229,1,2,26703,0,ITC,ITC4,3,Lombardia
2021-04-02,MOL,1386,680,706,47,0,675,0,658,4,2,625,761,ITF,ITF2,14,Molise
2021-03-17,TOS,11380,4572,6808,364,273,879,189,9671,2,2,6865,4515,ITI,ITI1,9,Toscana
2020-12-31,LAZ,5291,2121,3170,4987,12,13,279,0,0,0,5291,0,ITI,ITI4,12,Lazio
2021-03-25,VEN,25689,10882,14807,1395,344,10538,1007,9921,225,2259,19627,6062,ITH,ITH3,5,Veneto
2021-02-26,MAR,3635,1502,2133,449,34,205,385,2519,4,39,3159,476,ITI,ITI3,11,Marche
2021-01-26,PAT,542,154,388,441,16,1,84,0,0,0,27,515,ITH,ITH2,4,Provincia Autonoma Trento
2021-02-07,PUG,1578,669,909,1039,224,5,309,0,0,1,253,1325,ITF,ITF4,16,Puglia
2021-02-15,PAB,72,42,30,17,2,8,40,5,0,0,26,46,ITH,ITH1,4,Provincia Autonoma Bolzano / Bozen
2021-02-14,TOS,8993,2567,6426,3033,549,5064,81,0,261,5,8883,110,ITI,ITI1,9,Toscana
2021-01-11,FVG,1883,609,1274,1501,3,333,46,0,0,0,1883,0,ITH,ITH4,6,Friuli-Venezia Giulia
2021-02-22,CAL,1997,1013,984,728,48,495,166,552,3,5,1441,556,ITF,ITF6,18,Calabria
2021-04-19,CAL,2389,1088,1301,87,7,1863,19,351,7,55,1847,542,ITF,ITF6,18,Calabria
2021-03-13,LOM,27086,9739,17347,3750,989,3001,264,10326,617,8139,21024,6062,ITC,ITC4,3,Lombardia
2021-02-02,ABR,1798,677,1121,1243,67,346,142,0,0,0,241,1557,ITF,ITF1,13,Abruzzo
2021-02-20,VEN,6419,2013,4406,1905,35,162,100,968,6,3243,6350,69,ITH,ITH3,5,Veneto
2021-01-26,TOS,5393,1792,3601,4358,81,3,951,0,0,0,219,5174,ITI,ITI1,9,Toscana
2021-01-01,UMB,273,105,168,272,0,1,0,0,0,0,273,0,ITI,ITI2,10,Umbria
2021-03-18,LIG,4987,2125,2862,634,69,484,98,3691,6,5,2017,2970,ITC,ITC3,7,Liguria
2021-04-07,CAM,24739,11772,12967,348,42,16419,62,6618,207,1043,20017,4722,ITF,ITF3,15,Campania
2021-03-05,LIG,4861,2147,2714,795,65,267,81,3336,312,5,3737,1124,ITC,ITC3,7,Liguria
2020-12-31,TOS,805,202,603,97,10,0,698,0,0,0,805,0,ITI,ITI1,9,Toscana
2021-01-21,MOL,6,2,4,0,6,0,0,0,0,0,6,0,ITF,ITF2,14,Molise
